Transitory
An Interactive Fiction by lizzard
Release 1 / Serial number 190126 / Inform 7 build 6M62 (I6/v6.33 lib 6/12N) SD

Mission 24th St
You are underground, on a BART platform. The hollow sound of vibrating train rails echoes through the station. Boxy concrete arches run overhead and then frame the sides of the train tunnel. If you look around, you will probably find the elevator. On the platform itself, the floor is covered with long brick-red tiles, while the median walls are tiled in muted orange, gold, and brown, like a desert sunset.

9:00 am

>enter elevator
You can't see any such thing.

>n
The doors slowly close. The elevator almost imperceptibly moves. Time passes. You smell a lot of things, wishing you couldn't. The doors open again.

Mission 24th Platform Elevator

>out
But you aren't in anything at the moment.

* * *

Transitory
An Interactive Fiction by lizzard
Release 1 / Serial number 190126 / Inform 7 build 6M62 (I6/v6.33 lib 6/12N) SD

Mission 24th St
You are underground, on a BART platform. The hollow sound of vibrating train rails echoes through the station. Boxy concrete arches run overhead and then frame the sides of the train tunnel. If you look around, you will probably find the elevator. On the platform itself, the floor is covered with long brick-red tiles, while the median walls are tiled in muted orange, gold, and brown, like a desert sunset.

9:00 am

>enter train
You get into the Red Line train.

The door closes.

The Red Line train starts moving again.

>l
The Red Line train
The Red Line train stops at Richmond. The door opens.

The Orange Line train pulls up. The door opens.

>l
Richmond (in the Red Line train)
You are on a BART platform.

You can see an Orange Line train here.

>l
Richmond (in the Red Line train)
You are on a BART platform.

You can see an Orange Line train here.

The door closes.

The Red Line train starts moving again.

>l
The Red Line train
The Red Line train stops at El Cerrito del Norte. The door opens.

>l
El Cerrito del Norte (in the Red Line train)

>l
El Cerrito del Norte (in the Red Line train)
The door closes.

The Red Line train starts moving again.

>l
The Red Line train
The Red Line train stops at El Cerrito Plaza. The door opens.

>l
El Cerrito Plaza (in the Red Line train)

>l
El Cerrito Plaza (in the Red Line train)
The door closes.

The Red Line train starts moving again.

>l
The Red Line train
The Red Line train stops at North Berkeley. The door opens.

>l
North Berkeley (in the Red Line train)

>l
North Berkeley (in the Red Line train)
The door closes.

The Red Line train starts moving again.

>l
The Red Line train
The Red Line train stops at Downtown Berkeley. The door opens.

>l
Downtown Berkeley (in the Red Line train)

>l
Downtown Berkeley (in the Red Line train)
The door closes.

The Red Line train starts moving again.

>l
The Red Line train
The Red Line train stops at Ashby. The door opens.

>l
Ashby (in the Red Line train)

>l
Ashby (in the Red Line train)
The door closes.

The Red Line train starts moving again.

>l
The Red Line train
The Red Line train stops at MacArthur. The door opens.

>l
MacArthur (in the Red Line train)

>l
MacArthur (in the Red Line train)
The door closes.

The Red Line train starts moving again.

>l
The Red Line train
The Red Line train stops at Oakland 19th St. The door opens.

>l
Oakland 19th St (in the Red Line train)

>l
Oakland 19th St (in the Red Line train)
The door closes.

The Red Line train starts moving again.

>l
The Red Line train
The Red Line train stops at Oakland 12th St. The door opens.

>l
Oakland 12th St (in the Red Line train)

>l
Oakland 12th St (in the Red Line train)
The door closes.

The Red Line train starts moving again.

>l
The Red Line train
The Red Line train stops at West Oakland. The door opens.

>l
West Oakland (in the Red Line train)
You are underground, on a BART platform. Sounds of trains are all around you.

>l
West Oakland (in the Red Line train)
You are underground, on a BART platform. Sounds of trains are all around you.

The door closes.

The Red Line train starts moving again.

>l
The Red Line train
The Red Line train stops at Embarcadero. The door opens.

The Yellow Line train pulls up. The door opens.

>l
Embarcadero (in the Red Line train)
You are on a BART platform underground. Lots of people are around and there are muffled announcements over an intercom.

You can see a Yellow Line train here.

>l
Embarcadero (in the Red Line train)
You are on a BART platform underground. Lots of people are around and there are muffled announcements over an intercom.

You can see a Yellow Line train here.

The door closes.

The Red Line train starts moving again.

>l
The Red Line train
The Red Line train stops at Montgomery. The door opens.

>l
Montgomery (in the Red Line train)

>l
Montgomery (in the Red Line train)
The door closes.

The Red Line train starts moving again.

>l
The Red Line train
The Red Line train stops at Powell. The door opens.

>l
Powell (in the Red Line train)

>l
Powell (in the Red Line train)
The door closes.

The Red Line train starts moving again.

>l
The Red Line train
The Red Line train stops at Civic Center. The door opens.

>l
Civic Center (in the Red Line train)

>l
Civic Center (in the Red Line train)
The door closes.

The Red Line train starts moving again.

>l
The Red Line train
The Red Line train stops at Mission 16th St. The door opens.

>l
Mission 16th St (in the Red Line train)

>l
Mission 16th St (in the Red Line train)
The door closes.

The Red Line train starts moving again.

>l
The Red Line train
The Red Line train stops at Mission 24th St. The door opens.

>l
Mission 24th St (in the Red Line train)
You are underground, on a BART platform. The hollow sound of vibrating train rails echoes through the station. Boxy concrete arches run overhead and then frame the sides of the train tunnel. An elevator is in the median wall to the north. On the platform itself, the floor is covered with long brick-red tiles, while the median walls are tiled in muted orange, gold, and brown, like a desert sunset.

>l
Mission 24th St (in the Red Line train)
You are underground, on a BART platform. The hollow sound of vibrating train rails echoes through the station. Boxy concrete arches run overhead and then frame the sides of the train tunnel. An elevator is in the median wall to the north. On the platform itself, the floor is covered with long brick-red tiles, while the median walls are tiled in muted orange, gold, and brown, like a desert sunset.

The door closes.

The Red Line train starts moving again.

>l
The Red Line train
The Red Line train stops at Glen Park. The door opens.

>l
Glen Park (in the Red Line train)

>l
Glen Park (in the Red Line train)
The door closes.

The Red Line train starts moving again.

>l
The Red Line train
The Red Line train stops at Balboa Park. The door opens.

>l
Balboa Park (in the Red Line train)

>l
Balboa Park (in the Red Line train)
The door closes.

The Red Line train starts moving again.

>l
The Red Line train
The Red Line train stops at Daly City. The door opens.

The Blue Line train pulls up. The door opens.

The Green Line train pulls up. The door opens.

>l
Daly City (in the Red Line train)
You are on a BART platform. Fog drifts in from the nearby ocean.

You can see a Green Line train and a Blue Line train here.

>l
Daly City (in the Red Line train)
You are on a BART platform. Fog drifts in from the nearby ocean.

You can see a Green Line train and a Blue Line train here.

The door closes.

The Red Line train starts moving again.

>l
The Red Line train
The Red Line train stops at Millbrae. The door opens.

>l
Millbrae (in the Red Line train)
You are on a BART platform outside. Many people and trains are all around. There are weird looking cement statues of commuters in awkward positions on the platform.

>l
Millbrae (in the Red Line train)
You are on a BART platform outside. Many people and trains are all around. There are weird looking cement statues of commuters in awkward positions on the platform.

The door closes.

The Red Line train starts moving again.

>l
The Red Line train
The Red Line train stops at Daly City. The door opens.

* * *

Transitory
An Interactive Fiction by lizzard
Release 1 / Serial number 190126 / Inform 7 build 6M62 (I6/v6.33 lib 6/12N) SD

Mission 24th St
You are underground, on a BART platform. The hollow sound of vibrating train rails echoes through the station. Boxy concrete arches run overhead and then frame the sides of the train tunnel. If you look around, you will probably find the elevator. On the platform itself, the floor is covered with long brick-red tiles, while the median walls are tiled in muted orange, gold, and brown, like a desert sunset.

9:00 am

>i
You are carrying:
  Wraparound mirrorshades

Next Yellow Line train in 7 minutes.

Next Red Line train in 31 minutes.

Next Green Line train in 3 minutes.

9:01 am

>wear mirrorshades
You put on Wraparound mirrorshades.

Next Yellow Line train in 6 minutes.

Next Red Line train in 30 minutes.

Next Green Line train in 2 minutes.

9:02 am

>l
Mission 24th St
You are underground, on a BART platform. The hollow sound of vibrating train rails echoes through the station. Boxy concrete arches run overhead and then frame the sides of the train tunnel. If you look around, you will probably find the elevator. On the platform itself, the floor is covered with long brick-red tiles, while the median walls are tiled in muted orange, gold, and brown, like a desert sunset.

You can see an elevator (empty) here.

Next Yellow Line train in 6 minutes.

Next Red Line train in 30 minutes.

Next Green Line train in 2 minutes.

9:03 am

* * *

Transitory
An Interactive Fiction by lizzard
Release 1 / Serial number 190126 / Inform 7 build 6M62 (I6/v6.33 lib 6/12N) SD

Mission 24th St
You are underground, on a BART platform. The hollow sound of vibrating train rails echoes through the station. Boxy concrete arches run overhead and then frame the sides of the train tunnel. If you look around, you will probably find the elevator. On the platform itself, the floor is covered with long brick-red tiles, while the median walls are tiled in muted orange, gold, and brown, like a desert sunset.

9:00 am

>l
Mission 24th St
You are underground, on a BART platform. The hollow sound of vibrating train rails echoes through the station. Boxy concrete arches run overhead and then frame the sides of the train tunnel. If you look around, you will probably find the elevator. On the platform itself, the floor is covered with long brick-red tiles, while the median walls are tiled in muted orange, gold, and brown, like a desert sunset.

Next Yellow Line train in 7 minutes.

Next Red Line train in 31 minutes.

Next Green Line train in 7 minutes.

Next Blue Line train in 7 minutes.

9:01 am

>l
Mission 24th St
You are underground, on a BART platform. The hollow sound of vibrating train rails echoes through the station. Boxy concrete arches run overhead and then frame the sides of the train tunnel. If you look around, you will probably find the elevator. On the platform itself, the floor is covered with long brick-red tiles, while the median walls are tiled in muted orange, gold, and brown, like a desert sunset.

You can see an elevator (empty) here.

Next Yellow Line train in 6 minutes.

Next Red Line train in 30 minutes.

Next Green Line train in 6 minutes.

Next Blue Line train in 6 minutes.

9:02 am

>enter
You get into the elevator. The doors close. Best to go up or down as fast as possible to get out of the stench.

Next Yellow Line train in 6 minutes.

Next Red Line train in 30 minutes.

9:03 am

>up
 The elevator almost imperceptibly moves up. Time passes. You smell a lot of things, wishing you couldn't. The doors open again.

Mission 24th Concourse (in the elevator)
Enormous concrete buttresses soar overhead, like a futuristic 70s airplane hangar. Music echoes hauntingly from a monumental stairwell rising up to the plaza, combining with the wild harmonics of trains below. 

9:04 am

>up
 The elevator almost imperceptibly moves up. Time passes. You smell a lot of things, wishing you couldn't. The doors open again.

Calle 24 Northeast Plaza (in the elevator)
Palm trees sway high overhead. Delicate metal rails surround the enormous circular stairwell that goes down to the station concourse. All around you are little shops, restaurants, taquerias, people talking, buses pulling up to the stops on Mission and on 24th Street, music blasting from cars going by. A huge mural runs across the wall of the taqueria bordering the plaza to the north, of a gleaming BART train carried on the backs of determined workers amid a geometric cityscape.

You can see a tamale lady and a yelling preacher here.

A tamale lady watches the people passing by.

If you look around past the crowds you might find the elevator.

9:05 am

>exit
You get out of the elevator.

Calle 24 Northeast Plaza
Palm trees sway high overhead. Delicate metal rails surround the enormous circular stairwell that goes down to the station concourse. All around you are little shops, restaurants, taquerias, people talking, buses pulling up to the stops on Mission and on 24th Street, music blasting from cars going by. A huge mural runs across the wall of the taqueria bordering the plaza to the north, of a gleaming BART train carried on the backs of determined workers amid a geometric cityscape.

You can see an elevator (empty), a tamale lady and a yelling preacher here.

A tamale lady says "Tamales de pollo!"
.

9:06 am

* * *

>enter elevator
You get into the elevator. The doors close. Best to go up or down as fast as possible to get out of the stench.

Next Yellow Line train in 6 minutes.

Next Red Line train in 30 minutes.

9:03 am

>up
 The elevator almost imperceptibly moves up. Time passes. You smell a lot of things, wishing you couldn't. The doors open again.

Mission 24th Concourse (in the elevator)
Enormous concrete buttresses soar overhead, like a futuristic 70s airplane hangar. Music echoes hauntingly from a monumental stairwell rising up to the plaza, combining with the wild harmonics of trains below. 

Next Yellow Line train in 6 minutes.

Next Red Line train in 30 minutes.

9:04 am

>up
 The elevator almost imperceptibly moves up. Time passes. You smell a lot of things, wishing you couldn't. The doors open again.

Calle 24 Northeast Plaza (in the elevator)
Palm trees sway high overhead. Delicate metal rails surround the enormous circular stairwell that goes down to the station concourse. All around you are little shops, restaurants, taquerias, people talking, buses pulling up to the stops on Mission and on 24th Street, music blasting from cars going by. A huge mural runs across the wall of the taqueria bordering the plaza to the north, of a gleaming BART train carried on the backs of determined workers amid a geometric cityscape.

You can see a tamale lady and a yelling preacher here.

A tamale lady watches the people passing by.

If you look around past the crowds you might find the elevator.

Next Yellow Line train in 6 minutes.

Next Red Line train in 30 minutes.

9:05 am

>exit
You get out of the elevator.

Calle 24 Northeast Plaza
Palm trees sway high overhead. Delicate metal rails surround the enormous circular stairwell that goes down to the station concourse. All around you are little shops, restaurants, taquerias, people talking, buses pulling up to the stops on Mission and on 24th Street, music blasting from cars going by. A huge mural runs across the wall of the taqueria bordering the plaza to the north, of a gleaming BART train carried on the backs of determined workers amid a geometric cityscape.

You can see an elevator (empty), a tamale lady and a yelling preacher here.

A tamale lady says "Tamales!"
.

Next Yellow Line train in 6 minutes.

Next Red Line train in 30 minutes.

9:06 am

>l
Calle 24 Northeast Plaza
Palm trees sway high overhead. Delicate metal rails surround the enormous circular stairwell that goes down to the station concourse. All around you are little shops, restaurants, taquerias, people talking, buses pulling up to the stops on Mission and on 24th Street, music blasting from cars going by. A huge mural runs across the wall of the taqueria bordering the plaza to the north, of a gleaming BART train carried on the backs of determined workers amid a geometric cityscape.

You can see an elevator (empty), a tamale lady and a yelling preacher here.

A tamale lady watches the people passing by.

Next Yellow Line train in 6 minutes.

Next Red Line train in 30 minutes.

9:07 am

* * *

>enter millbrae yellow line train
You get into the Millbrae Yellow Line train.

>l
Richmond (in the Millbrae Yellow Line train)
You can see a Millbrae Red Line train here.

The door closes.

The Millbrae Yellow Line train starts moving again.

* * *

>enter train
You get into the Millbrae Red Line train.

>l
Richmond (in the Millbrae Red Line train)

>l
Richmond (in the Millbrae Red Line train)

>exit
You get out of the Millbrae Red Line train.

Richmond
You can see a Millbrae Red Line train here.

The Richmond Red Line train pulls up. The door opens.

[** Programming error: tried to "move" Antioch train to Antioch train, which would make a loop: Antioch train in Antioch train **]

* * *

>l
Mission 24th St
You are underground, on a BART platform. The hollow sound of vibrating train rails echoes through the station. Boxy concrete arches run overhead and then frame the sides of the train tunnel. An elevator is in the median wall to the north. On the platform itself, the floor is covered with long brick-red tiles, while the median walls are tiled in muted orange, gold, and brown, like a desert sunset.

You can see an elevator (empty) here.

Next Yellow Line train in 6 minutes.

Next Red Line train in 30 minutes.

9:03 am

>l
Mission 24th St
You are underground, on a BART platform. The hollow sound of vibrating train rails echoes through the station. Boxy concrete arches run overhead and then frame the sides of the train tunnel. An elevator is in the median wall to the north. On the platform itself, the floor is covered with long brick-red tiles, while the median walls are tiled in muted orange, gold, and brown, like a desert sunset.

You can see an elevator (empty) here.

Next Yellow Line train in 5 minutes.

Next Red Line train in 29 minutes.

9:04 am

>l
Mission 24th St
You are underground, on a BART platform. The hollow sound of vibrating train rails echoes through the station. Boxy concrete arches run overhead and then frame the sides of the train tunnel. An elevator is in the median wall to the north. On the platform itself, the floor is covered with long brick-red tiles, while the median walls are tiled in muted orange, gold, and brown, like a desert sunset.

You can see an elevator (empty) here.

The Blue Line train pulls up. The door opens.

The Green Line train pulls up. The door opens.

Next Yellow Line train in 4 minutes.

9:05 am

>enter train
You get into the Millbrae Red Line train.

* * *

>l
Richmond (in the Millbrae Red Line train)

>l
Richmond (in the Millbrae Red Line train)
The Richmond Red Line train pulls up. The door opens.

[** Programming error: tried to "move" Antioch train to Antioch train, which would make a loop: Antioch train in Antioch train **]

* * *

>l
Mission 24th St
You are underground, on a BART platform. The hollow sound of vibrating train rails echoes through the station. Boxy concrete arches run overhead and then frame the sides of the train tunnel. An elevator is in the median wall to the north. On the platform itself, the floor is covered with long brick-red tiles, while the median walls are tiled in muted orange, gold, and brown, like a desert sunset.

You can see an elevator (empty) here.

The Blue Line train pulls up. The door opens.

The Green Line train pulls up. The door opens.

Next Yellow Line train in 4 minutes.

9:05 am

>l
Mission 24th St
You are underground, on a BART platform. The hollow sound of vibrating train rails echoes through the station. Boxy concrete arches run overhead and then frame the sides of the train tunnel. An elevator is in the median wall to the north. On the platform itself, the floor is covered with long brick-red tiles, while the median walls are tiled in muted orange, gold, and brown, like a desert sunset.

You can see a Green Line train, a Blue Line train and an elevator (empty) here.

Next Yellow Line train in 4 minutes.

9:06 am

>l
Mission 24th St
You are underground, on a BART platform. The hollow sound of vibrating train rails echoes through the station. Boxy concrete arches run overhead and then frame the sides of the train tunnel. An elevator is in the median wall to the north. On the platform itself, the floor is covered with long brick-red tiles, while the median walls are tiled in muted orange, gold, and brown, like a desert sunset.

You can see an elevator (empty), a Green Line train and a Blue Line train here.

The door of the Blue Line train closes.

The Blue Line train sets off.
The door of the Green Line train closes.

The Green Line train sets off.

Next Yellow Line train in 3 minutes.

9:07 am

>l
Mission 24th St
You are underground, on a BART platform. The hollow sound of vibrating train rails echoes through the station. Boxy concrete arches run overhead and then frame the sides of the train tunnel. An elevator is in the median wall to the north. On the platform itself, the floor is covered with long brick-red tiles, while the median walls are tiled in muted orange, gold, and brown, like a desert sunset.

You can see an elevator (empty) here.

Next Yellow Line train in 2 minutes.

9:08 am

>enter red line
(the Red Line train)
You get into the Red Line train.

>l
Embarcadero (in the Red Line train)
You are on a BART platform underground. Lots of people are around and there are muffled announcements over an intercom.

You can see a Yellow Line train here.

The door closes.

The Red Line train starts moving again.

>l
The Red Line train
The Red Line train stops at Mission 24th St. The door opens.

>l
Mission 24th St (in the Red Line train)
You are underground, on a BART platform. The hollow sound of vibrating train rails echoes through the station.

>exit
You get out of the Red Line train.

Mission 24th St
You are underground, on a BART platform. The hollow sound of vibrating train rails echoes through the station.

You can see a Red Line train here.

The door of the Red Line train closes.

The Red Line train sets off.

>up
Mission 24th Concourse

* * *

>l
Mission 24th St
You are underground, on a BART platform. The hollow sound of vibrating train rails echoes through the station. Boxy concrete arches run overhead and then frame the sides of the train tunnel. An elevator is in the median wall to the north. On the platform itself, the floor is covered with long brick-red tiles, while the median walls are tiled in muted orange, gold, and brown, like a desert sunset.

You can see an elevator (empty) here.

Next Yellow Line train in 2 minutes.

9:08 am

>l
Mission 24th St
You are underground, on a BART platform. The hollow sound of vibrating train rails echoes through the station. Boxy concrete arches run overhead and then frame the sides of the train tunnel. An elevator is in the median wall to the north. On the platform itself, the floor is covered with long brick-red tiles, while the median walls are tiled in muted orange, gold, and brown, like a desert sunset.

You can see an elevator (empty) here.

Next Yellow Line train in 2 minutes.

9:09 am

>l
Mission 24th St
You are underground, on a BART platform. The hollow sound of vibrating train rails echoes through the station. Boxy concrete arches run overhead and then frame the sides of the train tunnel. An elevator is in the median wall to the north. On the platform itself, the floor is covered with long brick-red tiles, while the median walls are tiled in muted orange, gold, and brown, like a desert sunset.

You can see an elevator (empty) here.

Next Yellow Line train in 1 minutes.

9:10 am

>l
Mission 24th St
You are underground, on a BART platform. The hollow sound of vibrating train rails echoes through the station. Boxy concrete arches run overhead and then frame the sides of the train tunnel. An elevator is in the median wall to the north. On the platform itself, the floor is covered with long brick-red tiles, while the median walls are tiled in muted orange, gold, and brown, like a desert sunset.

You can see an elevator (empty) here.

The Yellow Line train pulls up. The door opens.

Next Yellow Line train in 0 minutes.

9:11 am

>l
Richmond Platform

>l
Richmond Platform

>wait
Time passes.

>l
Richmond Platform

>e
Richmond Platform 2 Northbound

>l
Richmond Platform 2 Northbound

>w
Richmond Platform

>w
Richmond Platform 1 Southbound
You can see a Millbrae Red Line train here.

>enter train
You get into the Millbrae Red Line train.

>l
Richmond Platform 1 Southbound (in the Millbrae Red Line train)

>l
Richmond Platform 1 Southbound (in the Millbrae Red Line train)

>exit
You get out of the Millbrae Red Line train.

Richmond Platform 1 Southbound
You can see a Millbrae Red Line train here.

>l
Richmond Platform 1 Southbound
You can see a Millbrae Red Line train here.

>l
Richmond Platform 1 Southbound
You can see a Millbrae Red Line train here.

>e
Richmond Platform

>e
Richmond Platform 2 Northbound
The Richmond Red Line train pulls up. The door opens.

>enter
You get into the Richmond Red Line train.

>l
Richmond Platform 2 Northbound (in the Richmond Red Line train)
The door closes.

The Richmond Red Line train starts moving again.

>l
The Richmond Red Line train
The Richmond Red Line train stops at Millbrae Platform 2 Northbound. The door opens.

>l
Millbrae Platform 2 Northbound (in the Richmond Red Line train)

>l
Millbrae Platform 2 Northbound (in the Richmond Red Line train)
The door closes.

The Richmond Red Line train starts moving again.

>l
The Richmond Red Line train
The Richmond Red Line train stops at Embarcadero Platform 2 Northbound. The door opens.

>l
Embarcadero Platform 2 Northbound (in the Richmond Red Line train)

>l
Embarcadero Platform 2 Northbound (in the Richmond Red Line train)
The door closes.

The Richmond Red Line train starts moving again.

>l
The Richmond Red Line train
The Richmond Red Line train stops at Richmond Platform 2 Northbound. The door opens.

>l
Richmond Platform 2 Northbound (in the Richmond Red Line train)

>l
Richmond Platform 2 Northbound (in the Richmond Red Line train)
The door closes.

The Richmond Red Line train starts moving again.

* * *

>l
Mission 24th St
You are underground, on a BART platform. The hollow sound of vibrating train rails echoes through the station. Boxy concrete arches run overhead and then frame the sides of the train tunnel. An elevator is in the median wall to the north. On the platform itself, the floor is covered with long brick-red tiles, while the median walls are tiled in muted orange, gold, and brown, like a desert sunset.

You can see a Green Line train, a Blue Line train and an elevator (empty) here.

Next Yellow Line train in 4 minutes.

9:06 am

>wait
Time passes.

>wait
Time passes.

* * *

>l
Mission 24th St
You are underground, on a BART platform. The hollow sound of vibrating train rails echoes through the station. Boxy concrete arches run overhead and then frame the sides of the train tunnel. An elevator is in the median wall to the north. On the platform itself, the floor is covered with long brick-red tiles, while the median walls are tiled in muted orange, gold, and brown, like a desert sunset.

You can see an elevator (empty) here.

The Blue Line train pulls up. The door opens.

The Green Line train pulls up. The door opens.

Next Yellow Line train in 4 minutes.

9:05 am

>wait
Time passes.

>up
Mission 24th Concourse
Enormous concrete buttresses soar overhead, like a futuristic 70s airplane hangar. Music echoes hauntingly from a monumental stairwell rising up to the plaza, combining with the wild harmonics of trains below. There is an elevator to the platform to the north, and another elevator to the street to the northwest.

>d
Mission 24th St
You are underground, on a BART platform. The hollow sound of vibrating train rails echoes through the station. Boxy concrete arches run overhead and then frame the sides of the train tunnel. An elevator is in the median wall to the north. On the platform itself, the floor is covered with long brick-red tiles, while the median walls are tiled in muted orange, gold, and brown, like a desert sunset.

You can see a Red Line train here.

>n
The doors slowly close. The elevator almost imperceptibly moves. Time passes. You smell a lot of things, wishing you couldn't. The doors open again, looking south.

Mission 24th Platform Elevator
The elevator is grimy and smells like pee.

>s
Mission 24th Concourse
Enormous concrete buttresses soar overhead, like a futuristic 70s airplane hangar. Music echoes hauntingly from a monumental stairwell rising up to the plaza, combining with the wild harmonics of trains below. There is an elevator to the platform to the north, and another elevator to the street to the northwest.

>nw
The doors slowly close. The elevator almost imperceptibly moves. Time passes. You smell a lot of things, wishing you couldn't. The doors open again, looking southeast.

Mission 24th Street Elevator

>se
Calle 24 Northeast Plaza
Palm trees sway high overhead. Delicate metal rails surround the enormous circular stairwell that goes down to the station concourse. All around you are little shops, restaurants, taquerias, people talking, buses pulling up to the stops on Mission and on 24th Street, music blasting from cars going by. A huge mural runs across the wall of the taqueria bordering the plaza to the north, of a gleaming BART train carried on the backs of determined workers amid a geometric cityscape.

You can see a tamale lady and a yelling preacher here.

A tamale lady watches the people passing by.

>look at tamale lady
A short, smiling woman in jeans and an army jacket stands next to a cooler on wheels.

A tamale lady watches the people passing by.

>l
Calle 24 Northeast Plaza
Palm trees sway high overhead. Delicate metal rails surround the enormous circular stairwell that goes down to the station concourse. All around you are little shops, restaurants, taquerias, people talking, buses pulling up to the stops on Mission and on 24th Street, music blasting from cars going by. A huge mural runs across the wall of the taqueria bordering the plaza to the north, of a gleaming BART train carried on the backs of determined workers amid a geometric cityscape.

You can see a tamale lady and a yelling preacher here.

A tamale lady watches the people passing by.

>s
Calle 24 Southeast Corner
This busy street corner by the McDonalds is grimy. It's basically a crowded spot where people wait to cross the street. Across Mission to the west, there's a nice plaza with a busy market. Across 24th Street to the north, another lovely plaza with musicians, preachers, and some places to sit.

You can see a raccoon here.

A raccoon hides in a little nook, eating some discarded fries.

>w
Calle 24 Southwest Plaza
Little tables and tent-covered booths are scattered throughout this busy plaza, with people selling souvenirs from Mexico and Guatemala, shopping bags, embroidered huipil blouses, woolen ponchos, phone chargers and cases, jewelry, and flowers. Many kinds of music are playing here - norteo blasts its cheerful accordions from speakers at a booth, saxophone notes float up from the huge, round stairwell which goes down to the station, songs blare from passing cars. There is a sloping area useful as a stage underneath the Coffee and Mission mural to the west.

* * *

>l
Mission 24th St
You are underground, on a BART platform. The hollow sound of vibrating train rails echoes through the station. Boxy concrete arches run overhead and then frame the sides of the train tunnel. An elevator is in the median wall to the north. On the platform itself, the floor is covered with long brick-red tiles, while the median walls are tiled in muted orange, gold, and brown, like a desert sunset.

You can see an elevator (empty) here.

Next Yellow Line train in 5 minutes.

Next Red Line train in 29 minutes.

9:04 am

>wait
Time passes.

The Blue Line train pulls up. The door opens.

The Green Line train pulls up. The door opens.

Next Yellow Line train in 4 minutes.

Next Red Line train in 28 minutes.

9:05 am

>enter blue line
(the Blue Line train)
You get into the Blue Line train.

Next Yellow Line train in 4 minutes.

Next Red Line train in 28 minutes.

9:06 am

>l
Mission 24th St (in the Blue Line train)
You are underground, on a BART platform. The hollow sound of vibrating train rails echoes through the station. Boxy concrete arches run overhead and then frame the sides of the train tunnel. An elevator is in the median wall to the north. On the platform itself, the floor is covered with long brick-red tiles, while the median walls are tiled in muted orange, gold, and brown, like a desert sunset.

You can see an elevator (empty) and a Green Line train here.

The door closes.

The Blue Line train starts moving again.

9:07 am

>l
The Blue Line train
The Blue Line train stops at Embarcadero. The door opens.

The Green Line train pulls up. The door opens.

Next Red Line train in 16 minutes.

9:08 am

>exit
You get out of the Blue Line train.

Embarcadero
You are on a BART platform underground. Lots of people are around and there are muffled announcements over an intercom.

You can see a Green Line train, a Blue Line train and a Yellow Line train here.

Next Red Line train in 16 minutes.

9:09 am

>l
Embarcadero
You are on a BART platform underground. Lots of people are around and there are muffled announcements over an intercom.

You can see an elevator (empty), a Green Line train, a Blue Line train and a Yellow Line train here.

The door of the Yellow Line train closes.

The Yellow Line train sets off.
The door of the Blue Line train closes.

The Blue Line train sets off.
The door of the Green Line train closes.

The Green Line train sets off.

Next Yellow Line train in 3 minutes.

Next Red Line train in 15 minutes.

9:10 am

>l
Embarcadero
You are on a BART platform underground. Lots of people are around and there are muffled announcements over an intercom.

You can see an elevator (empty) here.

Next Yellow Line train in 2 minutes.

Next Red Line train in 14 minutes.

9:11 am

* * *

>wait
Time passes.

Next Yellow Line train in 6 minutes.

Next Red Line train in 30 minutes.

Next Green Line train in 6 minutes.

Next Blue Line train in 6 minutes.

9:03 am

>wait
Time passes.

Next Yellow Line train in 5 minutes.

Next Red Line train in 29 minutes.

Next Green Line train in 5 minutes.

Next Blue Line train in 5 minutes.

9:04 am

>wait
Time passes.

Next Yellow Line train in 4 minutes.

Next Red Line train in 28 minutes.

Next Green Line train in 4 minutes.

Next Blue Line train in 4 minutes.

9:05 am

>wait
Time passes.

Next Yellow Line train in 4 minutes.

Next Red Line train in 28 minutes.

Next Green Line train in 4 minutes.

Next Blue Line train in 4 minutes.

9:06 am

>wait
Time passes.

Next Yellow Line train in 3 minutes.

Next Red Line train in 27 minutes.

Next Green Line train in 3 minutes.

Next Blue Line train in 3 minutes.

9:07 am

>wait
Time passes.

Next Yellow Line train in 2 minutes.

Next Red Line train in 26 minutes.

Next Green Line train in 2 minutes.

Next Blue Line train in 2 minutes.

9:08 am

>wait
Time passes.

Next Yellow Line train in 2 minutes.

Next Red Line train in 26 minutes.

Next Green Line train in 2 minutes.

Next Blue Line train in 2 minutes.

9:09 am

>wait
Time passes.

Next Yellow Line train in 1 minutes.

Next Red Line train in 25 minutes.

Next Green Line train in 1 minutes.

Next Blue Line train in 1 minutes.

9:10 am

>wait
Time passes.

The Blue Line train pulls up. The door opens.

The Green Line train pulls up. The door opens.

The Yellow Line train pulls up. The door opens.

Next Red Line train in 24 minutes.

9:11 am

>enter red
You can't see any such thing.

9:11 am

>enter yellow
(the Yellow Line train)
You get into the Yellow Line train.

Next Red Line train in 24 minutes.

9:12 am

>l
Mission 24th St (in the Yellow Line train)
You are underground, on a BART platform. The hollow sound of vibrating train rails echoes through the station. Boxy concrete arches run overhead and then frame the sides of the train tunnel. If you look around, you will probably find the elevator. On the platform itself, the floor is covered with long brick-red tiles, while the median walls are tiled in muted orange, gold, and brown, like a desert sunset.

You can see an elevator (empty), a Green Line train and a Blue Line train here.

The door of the Blue Line train closes.

The Blue Line train sets off.
The door of the Green Line train closes.

The Green Line train sets off.
The door closes.

The Yellow Line train starts moving again.

9:13 am

>wait
Time passes.

The Yellow Line train stops at Mission 16th St. The door opens.

Next Red Line train in 20 minutes.

9:14 am

>l
Mission 16th St (in the Yellow Line train)
You are on a BART platform.

You can see a Green Line train and a Blue Line train here.

Next Red Line train in 20 minutes.

9:15 am

I beg your pardon?

9:15 am

>wait
Time passes.

The door of the Blue Line train closes.

The Blue Line train sets off.
The door of the Green Line train closes.

The Green Line train sets off.
The door closes.

The Yellow Line train starts moving again.

9:16 am

>wait
Time passes.

The Yellow Line train stops at Civic Center. The door opens.

Next Red Line train in 16 minutes.

9:17 am

>wait
Time passes.

Next Red Line train in 16 minutes.

9:18 am

>wait
Time passes.

The door of the Blue Line train closes.

The Blue Line train sets off.
The door of the Green Line train closes.

The Green Line train sets off.
The door closes.

The Yellow Line train starts moving again.

9:19 am

>wait
Time passes.

The Yellow Line train stops at Powell. The door opens.

Next Red Line train in 12 minutes.

9:20 am

>wait
Time passes.

Next Red Line train in 12 minutes.

9:21 am

>wait
Time passes.

The door of the Blue Line train closes.

The Blue Line train sets off.
The door of the Green Line train closes.

The Green Line train sets off.
The door closes.

The Yellow Line train starts moving again.

9:22 am

>wait
Time passes.

The Yellow Line train stops at Montgomery. The door opens.

Next Red Line train in 8 minutes.

9:23 am

>wait
Time passes.

Next Red Line train in 8 minutes.

9:24 am

>wait
Time passes.

The door of the Blue Line train closes.

The Blue Line train sets off.
The door of the Green Line train closes.

The Green Line train sets off.
The door closes.

The Yellow Line train starts moving again.

9:25 am

>wait
Time passes.

The Yellow Line train stops at Embarcadero. The door opens.

Next Red Line train in 4 minutes.

9:26 am

>wait
Time passes.

Next Red Line train in 4 minutes.

9:27 am

>wait
Time passes.

The door of the Blue Line train closes.

The Blue Line train sets off.
The door of the Green Line train closes.

The Green Line train sets off.
The door closes.

The Yellow Line train starts moving again.

9:28 am

>wait
Time passes.

The Yellow Line train stops at West Oakland. The door opens.

The Red Line train pulls up. The door opens.

9:29 am

>wait
Time passes.

9:30 am

>wait
Time passes.

The door of the Blue Line train closes.

The Blue Line train sets off.
The door of the Green Line train closes.

The Green Line train sets off.
The door closes.

The Yellow Line train starts moving again.

9:31 am

>wait
Time passes.

The Yellow Line train stops at Oakland 12th St. The door opens.

Next Orange Line train in 16 minutes.

9:32 am

>exit
You get out of the Yellow Line train.

Oakland 12th St
You are on a BART platform.

You can see a Yellow Line train here.

Next Orange Line train in 16 minutes.

9:33 am

>l
Oakland 12th St
You are on a BART platform.

You can see an elevator (empty) and a Yellow Line train here.

The door of the Yellow Line train closes.

The Yellow Line train sets off.

Next Yellow Line train in 3 minutes.

Next Orange Line train in 16 minutes.

9:34 am

>l
Oakland 12th St
You are on a BART platform.

You can see an elevator (empty) here.

Next Yellow Line train in 2 minutes.

Next Orange Line train in 16 minutes.

9:35 am

>l
Oakland 12th St
You are on a BART platform.

You can see an elevator (empty) here.

Next Yellow Line train in 2 minutes.

Next Orange Line train in 16 minutes.

9:36 am

>l
Oakland 12th St
You are on a BART platform.

You can see an elevator (empty) here.

Next Yellow Line train in 5 minutes.

Next Orange Line train in 16 minutes.

9:37 am

>l
Oakland 12th St
You are on a BART platform.

You can see an elevator (empty) here.

Next Yellow Line train in 4 minutes.

Next Orange Line train in 16 minutes.

9:38 am

* * *

>l
Mission 24th St
You are underground, on a BART platform. The hollow sound of vibrating train rails echoes through the station. Boxy concrete arches run overhead and then frame the sides of the train tunnel. If you look around, you will probably find the elevator. On the platform itself, the floor is covered with long brick-red tiles, while the median walls are tiled in muted orange, gold, and brown, like a desert sunset.

Next Yellow Line train in 7 minutes.

Next Red Line train in 31 minutes.

Next Green Line train in 7 minutes.

Next Blue Line train in 7 minutes.

9:01 am

>wait
Time passes.

* * *

Transitory
An Interactive Fiction by lizzard
Release 1 / Serial number 190126 / Inform 7 build 6M62 (I6/v6.33 lib 6/12N) SD

Mission 24th St
You are underground, on a BART platform. The hollow sound of vibrating train rails echoes through the station. Boxy concrete arches run overhead and then frame the sides of the train tunnel. If you look around, you will probably find the elevator. On the platform itself, the floor is covered with long brick-red tiles, while the median walls are tiled in muted orange, gold, and brown, like a desert sunset.

9:00 am

>look
Mission 24th St
You are underground, on a BART platform. The hollow sound of vibrating train rails echoes through the station. Boxy concrete arches run overhead and then frame the sides of the train tunnel. If you look around, you will probably find the elevator. On the platform itself, the floor is covered with long brick-red tiles, while the median walls are tiled in muted orange, gold, and brown, like a desert sunset.

Next Yellow Line train in 7 minutes.

Next Red Line train in 31 minutes.

Next Green Line train in 7 minutes.

Next Blue Line train in 7 minutes.

9:01 am

>l
Mission 24th St
You are underground, on a BART platform. The hollow sound of vibrating train rails echoes through the station. Boxy concrete arches run overhead and then frame the sides of the train tunnel. An elevator is in the median wall to the north. On the platform itself, the floor is covered with long brick-red tiles, while the median walls are tiled in muted orange, gold, and brown, like a desert sunset.

You can see an elevator (empty) here.

Next Yellow Line Train in 6 minutes.

9:02 am

* * *

>look
Mission 24th St
You are underground, on a BART platform. The hollow sound of vibrating train rails echoes through the station. Boxy concrete arches run overhead and then frame the sides of the train tunnel. If you look around, you will probably find the elevator. On the platform itself, the floor is covered with long brick-red tiles, while the median walls are tiled in muted orange, gold, and brown, like a desert sunset.

Next Yellow Line train in 7 minutes.

Next Red Line train in 31 minutes.

Next Green Line train in 7 minutes.

Next Blue Line train in 7 minutes.

9:01 am

>look
Mission 24th St
You are underground, on a BART platform. The hollow sound of vibrating train rails echoes through the station. Boxy concrete arches run overhead and then frame the sides of the train tunnel. If you look around, you will probably find the elevator. On the platform itself, the floor is covered with long brick-red tiles, while the median walls are tiled in muted orange, gold, and brown, like a desert sunset.

You can see an elevator (empty) here.

Next Yellow Line train in 6 minutes.

Next Red Line train in 30 minutes.

Next Green Line train in 2 minutes.

Next Blue Line train in 2 minutes.

9:02 am

>enter
You get into the elevator. The doors close. Best to go up or down as fast as possible to get out of the stench.

Next Yellow Line train in 6 minutes.

Next Red Line train in 30 minutes.

Next Green Line train in 2 minutes.

9:03 am

>up
 The elevator almost imperceptibly moves up. Time passes. You smell a lot of things, wishing you couldn't. The doors open again.

Mission 24th Concourse (in the elevator)
Enormous concrete buttresses soar overhead, like a futuristic 70s airplane hangar. Music echoes hauntingly from a monumental stairwell rising up to the plaza, combining with the wild harmonics of trains below.

9:04 am

>up
 The elevator almost imperceptibly moves up. Time passes. You smell a lot of things, wishing you couldn't. The doors open again.

Calle 24 Northeast Plaza (in the elevator)
Palm trees sway high overhead. Delicate metal rails surround the enormous circular stairwell that goes down to the station concourse. All around you are little shops, restaurants, taquerias, people talking, buses pulling up to the stops on Mission and on 24th Street, music blasting from cars going by. A huge mural runs across the wall of the taqueria bordering the plaza to the north, of a gleaming BART train carried on the backs of determined workers amid a geometric cityscape.

You can see a tamale lady and a yelling preacher here.

A tamale lady watches the people passing by.

If you look around past the crowds you might find the elevator.

9:05 am

>exit
You get out of the elevator.

Calle 24 Northeast Plaza
Palm trees sway high overhead. Delicate metal rails surround the enormous circular stairwell that goes down to the station concourse. All around you are little shops, restaurants, taquerias, people talking, buses pulling up to the stops on Mission and on 24th Street, music blasting from cars going by. A huge mural runs across the wall of the taqueria bordering the plaza to the north, of a gleaming BART train carried on the backs of determined workers amid a geometric cityscape.

You can see an elevator (empty), a tamale lady and a yelling preacher here.

A tamale lady watches the people passing by.

9:06 am

>s
Calle 24 Southeast Corner
This busy street corner by the McDonalds is grimy. It's basically a crowded spot where people wait to cross the street. Across Mission to the west, there's a nice plaza with a busy market. Across 24th Street to the north, another lovely plaza with musicians, preachers, and some places to sit.

You can see a raccoon here.

A raccoon hauls itsef out of a concrete trash bin.

9:07 am

>w
Calle 24 Southwest Plaza
Little tables and tent-covered booths are scattered throughout this busy plaza, with people selling souvenirs from Mexico and Guatemala, shopping bags, embroidered huipil blouses, woolen ponchos, phone chargers and cases, jewelry, and flowers. Many kinds of music are playing here - norteo blasts its cheerful accordions from speakers at a booth, saxophone notes float up from the huge, round stairwell which goes down to the station, songs blare from passing cars. There is a sloping area useful as a stage underneath the Coffee and Mission mural. Across 24th street to the north, there's a donut shop.

You can see a snazzy black powerchair and a flower seller here.

A flower seller beams at you with a huge happy grin.

9:08 am

>get in powerchair
You mount the snazzy black powerchair.

A flower seller beams at you with a huge happy grin.

9:09 am

>e
Calle 24 Southeast Corner (on the snazzy black powerchair)
This busy street corner by the McDonalds is grimy. It's basically a crowded spot where people wait to cross the street. Across Mission to the west, there's a nice plaza with a busy market. Across 24th Street to the north, another lovely plaza with musicians, preachers, and some places to sit.

You can see a raccoon here.

A raccoon hides in a little nook, eating some discarded fries.

9:10 am

>s
You can't go that way.

A raccoon has a little nap in a pile of trash.

9:11 am

>w
Calle 24 Southwest Plaza (on the snazzy black powerchair)
Little tables and tent-covered booths are scattered throughout this busy plaza, with people selling souvenirs from Mexico and Guatemala, shopping bags, embroidered huipil blouses, woolen ponchos, phone chargers and cases, jewelry, and flowers. Many kinds of music are playing here - norteo blasts its cheerful accordions from speakers at a booth, saxophone notes float up from the huge, round stairwell which goes down to the station, songs blare from passing cars. There is a sloping area useful as a stage underneath the Coffee and Mission mural. Across 24th street to the north, there's a donut shop.

You can see a flower seller here.

A flower seller watches the people passing by.

9:12 am

>e
Calle 24 Southeast Corner (on the snazzy black powerchair)
This busy street corner by the McDonalds is grimy. It's basically a crowded spot where people wait to cross the street. Across Mission to the west, there's a nice plaza with a busy market. Across 24th Street to the north, another lovely plaza with musicians, preachers, and some places to sit.

You can see a raccoon here.

A raccoon hauls itsef out of a concrete trash bin.

9:13 am

>n
Calle 24 Northeast Plaza (on the snazzy black powerchair)
Palm trees sway high overhead. Delicate metal rails surround the enormous circular stairwell that goes down to the station concourse. All around you are little shops, restaurants, taquerias, people talking, buses pulling up to the stops on Mission and on 24th Street, music blasting from cars going by. A huge mural runs across the wall of the taqueria bordering the plaza to the north, of a gleaming BART train carried on the backs of determined workers amid a geometric cityscape.

You can see an elevator (empty), a tamale lady and a yelling preacher here.

A tamale lady watches the people passing by.

9:14 am

>enter elevator
(getting off the snazzy black powerchair)
You get into the elevator. The doors close. Best to go up or down as fast as possible to get out of the stench.

A tamale lady says "Tamales!"
.

9:15 am

>exit
You get out of the elevator.

Calle 24 Northeast Plaza
Palm trees sway high overhead. Delicate metal rails surround the enormous circular stairwell that goes down to the station concourse. All around you are little shops, restaurants, taquerias, people talking, buses pulling up to the stops on Mission and on 24th Street, music blasting from cars going by. A huge mural runs across the wall of the taqueria bordering the plaza to the north, of a gleaming BART train carried on the backs of determined workers amid a geometric cityscape.

You can see an elevator (empty), a snazzy black powerchair, a tamale lady and a yelling preacher here.

A tamale lady says "Tamales de carne!"
.

9:16 am

>ride powerchair
You mount the snazzy black powerchair.

A tamale lady says "Tamales!"
.

9:17 am

>enter elevator by powerchair
I only understood you as far as wanting to enter the elevator.

9:17 am

* * *

>l
Mission 24th St
You are underground, on a BART platform. The hollow sound of vibrating train rails echoes through the station. Boxy concrete arches run overhead and then frame the sides of the train tunnel. An elevator is in the median wall to the north. On the platform itself, the floor is covered with long brick-red tiles, while the median walls are tiled in muted orange, gold, and brown, like a desert sunset.

You can see an elevator (empty) here.

Next Yellow Line train in 6 minutes.

9:03 am

>l
Mission 24th St
You are underground, on a BART platform. The hollow sound of vibrating train rails echoes through the station. Boxy concrete arches run overhead and then frame the sides of the train tunnel. An elevator is in the median wall to the north. On the platform itself, the floor is covered with long brick-red tiles, while the median walls are tiled in muted orange, gold, and brown, like a desert sunset.

You can see an elevator (empty) here.

Next Yellow Line train in 5 minutes.

9:04 am

>l
Mission 24th St
You are underground, on a BART platform. The hollow sound of vibrating train rails echoes through the station. Boxy concrete arches run overhead and then frame the sides of the train tunnel. An elevator is in the median wall to the north. On the platform itself, the floor is covered with long brick-red tiles, while the median walls are tiled in muted orange, gold, and brown, like a desert sunset.

You can see an elevator (empty) here.

The Blue Line train pulls up. The door opens.

The Green Line train pulls up. The door opens.

Next Yellow Line train in 4 minutes.

9:05 am

* * *

>l
Mission 24th St
You are underground, on a BART platform. The hollow sound of vibrating train rails echoes through the station. Boxy concrete arches run overhead and then frame the sides of the train tunnel. An elevator is in the median wall to the north. On the platform itself, the floor is covered with long brick-red tiles, while the median walls are tiled in muted orange, gold, and brown, like a desert sunset.

You can see an elevator (empty) here.

Next Yellow Line train in 1 minutes.

9:10 am

>l
Mission 24th St
You are underground, on a BART platform. The hollow sound of vibrating train rails echoes through the station. Boxy concrete arches run overhead and then frame the sides of the train tunnel. An elevator is in the median wall to the north. On the platform itself, the floor is covered with long brick-red tiles, while the median walls are tiled in muted orange, gold, and brown, like a desert sunset.

You can see an elevator (empty) here.

The Yellow Line train pulls up. The door opens.

9:11 am

* * *

>look
Mission 24th St
You are underground, on a BART platform. The hollow sound of vibrating train rails echoes through the station. Boxy concrete arches run overhead and then frame the sides of the train tunnel. If you look around, you will probably find the elevator. On the platform itself, the floor is covered with long brick-red tiles, while the median walls are tiled in muted orange, gold, and brown, like a desert sunset.

You can see an elevator (empty) here.

Next Yellow Line train in 6 minutes.

Next Red Line train in 30 minutes.

Next Green Line train in 2 minutes.

Next Blue Line train in 2 minutes.

9:03 am

>l
Mission 24th St
You are underground, on a BART platform. The hollow sound of vibrating train rails echoes through the station. Boxy concrete arches run overhead and then frame the sides of the train tunnel. If you look around, you will probably find the elevator. On the platform itself, the floor is covered with long brick-red tiles, while the median walls are tiled in muted orange, gold, and brown, like a desert sunset.

You can see an elevator (empty) here.

Next Yellow Line train in 5 minutes.

Next Red Line train in 29 minutes.

Next Green Line train in 1 minutes.

Next Blue Line train in 1 minutes.

9:04 am

>l
Mission 24th St
You are underground, on a BART platform. The hollow sound of vibrating train rails echoes through the station. Boxy concrete arches run overhead and then frame the sides of the train tunnel. If you look around, you will probably find the elevator. On the platform itself, the floor is covered with long brick-red tiles, while the median walls are tiled in muted orange, gold, and brown, like a desert sunset.

You can see an elevator (empty) here.

The Blue Line train pulls up. The door opens.

The Green Line train pulls up. The door opens.

Next Yellow Line train in 4 minutes.

Next Red Line train in 28 minutes.

9:05 am

>enter blue
(the Blue Line train)
You get into the Blue Line train.

Next Yellow Line train in 4 minutes.

Next Red Line train in 28 minutes.

9:06 am

>l
Mission 24th St (in the Blue Line train)
You are underground, on a BART platform. The hollow sound of vibrating train rails echoes through the station. Boxy concrete arches run overhead and then frame the sides of the train tunnel. If you look around, you will probably find the elevator. On the platform itself, the floor is covered with long brick-red tiles, while the median walls are tiled in muted orange, gold, and brown, like a desert sunset.

You can see an elevator (empty) and a Green Line train here.

The door closes.

The Blue Line train starts moving again.

9:07 am

>l
The Blue Line train
The Blue Line train stops at Embarcadero. The door opens.

The Green Line train pulls up. The door opens.

Next Yellow Line train in 12 minutes.

Next Red Line train in 16 minutes.

9:08 am

>l
Embarcadero (in the Blue Line train)
You are on a BART platform underground. Lots of people are around and there are muffled announcements over an intercom.

You can see a Green Line train here.

Next Yellow Line train in 12 minutes.

Next Red Line train in 16 minutes.

9:09 am

>l
Embarcadero (in the Blue Line train)
You are on a BART platform underground. Lots of people are around and there are muffled announcements over an intercom.

You can see an elevator (empty) and a Green Line train here.

The door closes.

The Blue Line train starts moving again.

9:10 am

>wait
Time passes.

The Blue Line train stops at West Oakland. The door opens.

The Green Line train pulls up. The door opens.

Next Yellow Line train in 12 minutes.

Next Red Line train in 12 minutes.

9:11 am

>wait 4
I only understood you as far as wanting to wait.

9:11 am

>wait
Time passes.

Next Yellow Line train in 12 minutes.

Next Red Line train in 12 minutes.

9:12 am

>wait
Time passes.

The door closes.

The Blue Line train starts moving again.

9:13 am

>w
You would have to get out of the Blue Line train first.

The Blue Line train stops at Dublin/Pleasanton. The door opens.

9:14 am

>w
You would have to get out of the Blue Line train first.

9:15 am

>w
You would have to get out of the Blue Line train first.

The door closes.

The Blue Line train starts moving again.

9:16 am

>w
You would have to get out of the Blue Line train first.

The Blue Line train stops at West Oakland. The door opens.

The Green Line train pulls up. The door opens.

Next Yellow Line train in 8 minutes.

Next Red Line train in 8 minutes.

9:17 am

>exit
You get out of the Blue Line train.

West Oakland
You are on a BART platform.

You can see a Green Line train and a Blue Line train here.

Next Yellow Line train in 8 minutes.

Next Red Line train in 8 minutes.

9:18 am

>l
West Oakland
You are on a BART platform.

You can see an elevator (empty), a Green Line train and a Blue Line train here.

The door of the Blue Line train closes.

The Blue Line train sets off.
The door of the Green Line train closes.

The Green Line train sets off.

Next Yellow Line train in 7 minutes.

Next Red Line train in 7 minutes.

Next Green Line train in 3 minutes.

Next Blue Line train in 3 minutes.

9:19 am

>l
West Oakland
You are on a BART platform.

You can see an elevator (empty) here.

Next Yellow Line train in 6 minutes.

Next Red Line train in 6 minutes.

Next Green Line train in 2 minutes.

Next Blue Line train in 2 minutes.

9:20 am

>l
West Oakland
You are on a BART platform.

You can see an elevator (empty) here.

Next Yellow Line train in 6 minutes.

Next Red Line train in 6 minutes.

Next Green Line train in 2 minutes.

Next Blue Line train in 2 minutes.

9:21 am

>l
West Oakland
You are on a BART platform.

You can see an elevator (empty) here.

Next Yellow Line train in 5 minutes.

Next Red Line train in 5 minutes.

Next Green Line train in 5 minutes.

Next Blue Line train in 5 minutes.

9:22 am

>l
West Oakland
You are on a BART platform.

You can see an elevator (empty) here.

Next Yellow Line train in 4 minutes.

Next Red Line train in 4 minutes.

Next Green Line train in 4 minutes.

Next Blue Line train in 4 minutes.

9:23 am

>l
West Oakland
You are on a BART platform.

You can see an elevator (empty) here.

Next Yellow Line train in 4 minutes.

Next Red Line train in 4 minutes.

Next Green Line train in 4 minutes.

Next Blue Line train in 4 minutes.

9:24 am

>l
West Oakland
You are on a BART platform.

You can see an elevator (empty) here.

Next Yellow Line train in 3 minutes.

Next Red Line train in 3 minutes.

Next Green Line train in 7 minutes.

Next Blue Line train in 7 minutes.

9:25 am

>l
West Oakland
You are on a BART platform.

You can see an elevator (empty) here.

Next Yellow Line train in 2 minutes.

Next Red Line train in 2 minutes.

Next Green Line train in 6 minutes.

Next Blue Line train in 6 minutes.

9:26 am

>w
You can't go that way.

Next Yellow Line train in 2 minutes.

Next Red Line train in 2 minutes.

Next Green Line train in 6 minutes.

Next Blue Line train in 6 minutes.

9:27 am

>wait
Time passes.

Next Yellow Line train in 1 minutes.

Next Red Line train in 1 minutes.

Next Green Line train in 5 minutes.

Next Blue Line train in 5 minutes.

9:28 am

>wait
Time passes.

The Yellow Line train pulls up. The door opens.

The Red Line train pulls up. The door opens.

Next Green Line train in 4 minutes.

Next Blue Line train in 4 minutes.

9:29 am

>enter yellow
(the Yellow Line train)
You get into the Yellow Line train.

Next Green Line train in 4 minutes.

Next Blue Line train in 4 minutes.

9:30 am

>l
West Oakland (in the Yellow Line train)
You are on a BART platform.

You can see an elevator (empty) and a Red Line train here.

The door closes.

The Yellow Line train starts moving again.

9:31 am

>l
The Yellow Line train
The Yellow Line train stops at Oakland 12th St. The door opens.

*** Run-time problem P21: Attempt to look up a non-existent correspondence in the table 'Table of Orange Line Schedule'.

Next Orange Line train in 2 minutes.

9:32 am

* * *

>look
Mission 24th St
You are underground, on a BART platform. The hollow sound of vibrating train rails echoes through the station. Boxy concrete arches run overhead and then frame the sides of the train tunnel. If you look around, you will probably find the elevator. On the platform itself, the floor is covered with long brick-red tiles, while the median walls are tiled in muted orange, gold, and brown, like a desert sunset.

Next Yellow Line train in 7 minutes.

Next Red Line train in 31 minutes.

Next Green Line train in 7 minutes.

Next Blue Line train in 7 minutes.

9:01 am

>n
Calle 24 Northwest Corner
Just outside the Chinese Food and Donuts shop, this lively streetcorner has buses pulling up along 24th Street, many cars going by, people crossing the street and just standing around, music blaring from passing cars and from the shops all around. Along Mission, high overhead, washingtonia palms stretch into the sky. To the east, there's another BART plaza with an elevator.

>l
Calle 24 Northwest Corner
Just outside the Chinese Food and Donuts shop, this lively streetcorner has buses pulling up along 24th Street, many cars going by, people crossing the street and just standing around, music blaring from passing cars and from the shops all around. Along Mission, high overhead, washingtonia palms stretch into the sky. To the east, there's another BART plaza with an elevator.

>e
Calle 24 Northeast Plaza
Palm trees sway high overhead. Delicate metal rails surround the enormous circular stairwell that goes down to the station concourse. All around you are little shops, restaurants, taquerias, people talking, buses pulling up to the stops on Mission and on 24th Street, music blasting from cars going by. A huge mural runs across the wall of the taqueria bordering the plaza to the north, of a gleaming BART train carried on the backs of determined workers amid a geometric cityscape.

You can see a tamale lady and a yelling preacher here.

A tamale lady shifts her weight from one foot to the other.

If you look around past the crowds you might find the elevator

>look
Calle 24 Northeast Plaza
Palm trees sway high overhead. Delicate metal rails surround the enormous circular stairwell that goes down to the station concourse. All around you are little shops, restaurants, taquerias, people talking, buses pulling up to the stops on Mission and on 24th Street, music blasting from cars going by. A huge mural runs across the wall of the taqueria bordering the plaza to the north, of a gleaming BART train carried on the backs of determined workers amid a geometric cityscape.

You can see an elevator (empty), a tamale lady and a yelling preacher here.

A tamale lady watches the people passing by.

* * *

>look
Mission 24th St
You are underground, on a BART platform. The hollow sound of vibrating train rails echoes through the station. Boxy concrete arches run overhead and then frame the sides of the train tunnel. If you look around, you will probably find the elevator. On the platform itself, the floor is covered with long brick-red tiles, while the median walls are tiled in muted orange, gold, and brown, like a desert sunset.

Next Yellow Line train in 7 minutes.

Next Red Line train in 31 minutes.

Next Green Line train in 7 minutes.

Next Blue Line train in 7 minutes.

9:01 am

>wait
Time passes.

Next Yellow Line train in 6 minutes.

Next Red Line train in 30 minutes.

Next Green Line train in 6 minutes.

Next Blue Line train in 6 minutes.

9:02 am

>wait
Time passes.

Next Yellow Line train in 6 minutes.

Next Red Line train in 30 minutes.

Next Green Line train in 6 minutes.

Next Blue Line train in 6 minutes.

9:03 am

* * *

>wait
Time passes.

The Blue Line train pulls up. The door opens.

The Green Line train pulls up. The door opens.

The Yellow Line train pulls up. The door opens.

Next Red Line train in 24 minutes.

9:11 am

>enter green
(the Green Line train)
You get into the Green Line train.

Next Red Line train in 24 minutes.

9:12 am

>wait
Time passes.

The door of the Blue Line train closes.

The Blue Line train sets off.
The door closes.

The Green Line train starts moving again.

9:13 am

>wait
Time passes.

The Green Line train stops at Mission 16th St. The door opens.

The Yellow Line train pulls up. The door opens.

Next Red Line train in 20 minutes.

9:14 am

>wait
Time passes.

Next Red Line train in 20 minutes.

9:15 am

>wait
Time passes.

The door of the Blue Line train closes.

The Blue Line train sets off.
The door closes.

The Green Line train starts moving again.

9:16 am

>wait
Time passes.

The Green Line train stops at Civic Center. The door opens.

The Yellow Line train pulls up. The door opens.

Next Red Line train in 16 minutes.

9:17 am

>wait
Time passes.

Next Red Line train in 16 minutes.

9:18 am

>wait
Time passes.

The door of the Blue Line train closes.

The Blue Line train sets off.
The door closes.

The Green Line train starts moving again.

9:19 am

>wait
Time passes.

The Green Line train stops at Powell. The door opens.

The Yellow Line train pulls up. The door opens.

Next Red Line train in 12 minutes.

9:20 am

>wait
Time passes.

Next Red Line train in 12 minutes.

9:21 am

>wait
Time passes.

The door of the Blue Line train closes.

The Blue Line train sets off.
The door closes.

The Green Line train starts moving again.

9:22 am

>wait
Time passes.

The Green Line train stops at Montgomery. The door opens.

The Yellow Line train pulls up. The door opens.

Next Red Line train in 8 minutes.

9:23 am

>wait
Time passes.

Next Red Line train in 8 minutes.

9:24 am

>wait
Time passes.

The door of the Blue Line train closes.

The Blue Line train sets off.
The door closes.

The Green Line train starts moving again.

9:25 am

>wait
Time passes.

The Green Line train stops at Embarcadero. The door opens.

The Yellow Line train pulls up. The door opens.

Next Red Line train in 4 minutes.

9:26 am

>wait
Time passes.

Next Red Line train in 4 minutes.

9:27 am

>wait
Time passes.

The door of the Blue Line train closes.

The Blue Line train sets off.
The door closes.

The Green Line train starts moving again.

9:28 am

>wait
Time passes.

The Green Line train stops at West Oakland. The door opens.

The Yellow Line train pulls up. The door opens.

The Red Line train pulls up. The door opens.

9:29 am

>wait
Time passes.

9:30 am

>wait
Time passes.

The door of the Blue Line train closes.

The Blue Line train sets off.
The door closes.

The Green Line train starts moving again.

9:31 am

>wait
Time passes.

The Green Line train stops at Lake Merritt. The door opens.

Next Orange Line train in 18 minutes.

9:32 am

>wait
Time passes.

Next Orange Line train in 18 minutes.

9:33 am

>wait
Time passes.

The door of the Blue Line train closes.

The Blue Line train sets off.
The door closes.

The Green Line train starts moving again.

9:34 am

>wait
Time passes.

The Green Line train stops at Fruitvale. The door opens.

Next Orange Line train in 20 minutes.

9:35 am

>wait
Time passes.

Next Orange Line train in 20 minutes.

9:36 am

>wait
Time passes.

The door of the Blue Line train closes.

The Blue Line train sets off.
The door closes.

The Green Line train starts moving again.

9:37 am

>wait
Time passes.

The Green Line train stops at Coliseum. The door opens.

Next Orange Line train in 22 minutes.

9:38 am

>wait
Time passes.

Next Orange Line train in 22 minutes.

9:39 am

>wait
Time passes.

The door of the Blue Line train closes.

The Blue Line train sets off.
The door closes.

The Green Line train starts moving again.

9:40 am

>wait
Time passes.

The Green Line train stops at San Leandro. The door opens.

Next Orange Line train in 24 minutes.

9:41 am

>wait
Time passes.

Next Orange Line train in 24 minutes.

9:42 am

>wait
Time passes.

The door of the Blue Line train closes.

The Blue Line train sets off.
The door closes.

The Green Line train starts moving again.

9:43 am

>wait
Time passes.

The Green Line train stops at Bay Fair. The door opens.

Next Orange Line train in 26 minutes.

9:44 am

>wait
Time passes.

Next Orange Line train in 26 minutes.

9:45 am

>wait
Time passes.

The door of the Blue Line train closes.

The Blue Line train sets off.
The door closes.

The Green Line train starts moving again.

9:46 am

>wait
Time passes.

The Green Line train stops at Hayward. The door opens.

Next Orange Line train in 28 minutes.

9:47 am

>wait
Time passes.

Next Orange Line train in 28 minutes.

9:48 am

>wait
Time passes.

The door closes.

The Green Line train starts moving again.

9:49 am

>wait
Time passes.

The Green Line train stops at South Hayward. The door opens.

Next Orange Line train in 30 minutes.

9:50 am

>wait
Time passes.

Next Orange Line train in 30 minutes.

9:51 am

>wait
Time passes.

The door closes.

The Green Line train starts moving again.

9:52 am

>wait
Time passes.

The Green Line train stops at Union City. The door opens.

Next Orange Line train in 32 minutes.

9:53 am

>wait
Time passes.

Next Orange Line train in 32 minutes.

9:54 am

>wait
Time passes.

The door closes.

The Green Line train starts moving again.

9:55 am

>wait
Time passes.

The Green Line train stops at Fremont. The door opens.

Next Orange Line train in 34 minutes.

9:56 am

>wait
Time passes.

Next Orange Line train in 34 minutes.

9:57 am

>wait
Time passes.

The door closes.

The Green Line train starts moving again.

9:58 am

>wait
Time passes.

The Green Line train stops at Warm Springs/South Fremont. The door opens.

Next Orange Line train in 36 minutes.

9:59 am

>wait
Time passes.

Next Orange Line train in 36 minutes.

10:00 am

>wait
Time passes.

The door closes.

The Green Line train starts moving again.

10:01 am

>wait
Time passes.

The Green Line train stops at Fremont. The door opens.

Next Orange Line train in 34 minutes.

10:02 am

>wait
Time passes.

Next Orange Line train in 34 minutes.

10:03 am

>wait
Time passes.

The door closes.

The Green Line train starts moving again.

10:04 am

>wait
Time passes.

The Green Line train stops at Union City. The door opens.

Next Orange Line train in 32 minutes.

10:05 am

>wait
Time passes.

Next Orange Line train in 32 minutes.

10:06 am

>wait
Time passes.

The door closes.

The Green Line train starts moving again.

10:07 am

>wait
Time passes.

The Green Line train stops at South Hayward. The door opens.

Next Orange Line train in 30 minutes.

10:08 am

>wait
Time passes.

Next Orange Line train in 30 minutes.

10:09 am

>wait
Time passes.

The door closes.

The Green Line train starts moving again.

10:10 am

>wait
Time passes.

The Green Line train stops at Hayward. The door opens.

Next Orange Line train in 28 minutes.

10:11 am

>wait
Time passes.

Next Orange Line train in 28 minutes.

10:12 am

>wait
Time passes.

The door closes.

The Green Line train starts moving again.

10:13 am

>wait
Time passes.

The Green Line train stops at Bay Fair. The door opens.

Next Blue Line train in 8 minutes.

Next Orange Line train in 26 minutes.

10:14 am

>wait
Time passes.

Next Blue Line train in 8 minutes.

Next Orange Line train in 26 minutes.

10:15 am

>wait
Time passes.

The door closes.

The Green Line train starts moving again.

10:16 am

>wait
Time passes.

The Green Line train stops at San Leandro. The door opens.

Next Blue Line train in 8 minutes.

Next Orange Line train in 24 minutes.

10:17 am

>wait
Time passes.

Next Blue Line train in 8 minutes.

Next Orange Line train in 24 minutes.

10:18 am

>wait
Time passes.

The door closes.

The Green Line train starts moving again.

10:19 am

>wait
Time passes.

The Green Line train stops at Coliseum. The door opens.

Next Blue Line train in 8 minutes.

Next Orange Line train in 22 minutes.

10:20 am

>wait
Time passes.

Next Blue Line train in 8 minutes.

Next Orange Line train in 22 minutes.

10:21 am

>wait
Time passes.

The door closes.

The Green Line train starts moving again.

10:22 am

>wait
Time passes.

The Green Line train stops at Fruitvale. The door opens.

Next Blue Line train in 8 minutes.

Next Orange Line train in 20 minutes.

10:23 am

>wait
Time passes.

Next Blue Line train in 8 minutes.

Next Orange Line train in 20 minutes.

10:24 am

>wait
Time passes.

The door closes.

The Green Line train starts moving again.

10:25 am

>wait
Time passes.

The Green Line train stops at Lake Merritt. The door opens.

Next Blue Line train in 8 minutes.

Next Orange Line train in 18 minutes.

10:26 am

>exit
You get out of the Green Line train.

Lake Merritt
You are on a BART platform.

You can see a Green Line train here.

Next Blue Line train in 8 minutes.

Next Orange Line train in 18 minutes.

10:27 am

>l
Lake Merritt
You are on a BART platform.

You can see an elevator (empty) and a Green Line train here.

The door of the Green Line train closes.

The Green Line train sets off.

Next Green Line train in 3 minutes.

Next Blue Line train in 11 minutes.

Next Orange Line train in 18 minutes.

10:28 am

>wait
Time passes.

Next Green Line train in 2 minutes.

Next Blue Line train in 10 minutes.

Next Orange Line train in 18 minutes.

10:29 am

>wait
Time passes.

Next Green Line train in 2 minutes.

Next Blue Line train in 10 minutes.

Next Orange Line train in 18 minutes.

10:30 am

>wait
Time passes.

Next Green Line train in 5 minutes.

Next Blue Line train in 13 minutes.

Next Orange Line train in 18 minutes.

10:31 am

>wait
Time passes.

Next Green Line train in 4 minutes.

Next Blue Line train in 12 minutes.

Next Orange Line train in 18 minutes.

10:32 am

>wait
Time passes.

Next Green Line train in 4 minutes.

Next Blue Line train in 12 minutes.

Next Orange Line train in 18 minutes.

10:33 am

>wait
Time passes.

Next Green Line train in 7 minutes.

Next Blue Line train in 15 minutes.

Next Orange Line train in 18 minutes.

10:34 am

>wait
Time passes.

Next Green Line train in 6 minutes.

Next Blue Line train in 14 minutes.

Next Orange Line train in 18 minutes.

10:35 am

>wait
Time passes.

Next Green Line train in 6 minutes.

Next Blue Line train in 14 minutes.

Next Orange Line train in 18 minutes.

10:36 am

>wait
Time passes.

Next Green Line train in 9 minutes.

Next Blue Line train in 17 minutes.

Next Orange Line train in 18 minutes.

10:37 am

>wait
Time passes.

Next Green Line train in 8 minutes.

Next Blue Line train in 16 minutes.

Next Orange Line train in 18 minutes.

10:38 am

>wait
Time passes.

Next Green Line train in 8 minutes.

Next Blue Line train in 16 minutes.

Next Orange Line train in 18 minutes.

10:39 am

>wait
Time passes.

Next Green Line train in 11 minutes.

Next Blue Line train in 19 minutes.

Next Orange Line train in 18 minutes.

10:40 am

>wait
Time passes.

Next Green Line train in 10 minutes.

Next Blue Line train in 18 minutes.

Next Orange Line train in 18 minutes.

10:41 am

>wait
Time passes.

Next Green Line train in 10 minutes.

Next Blue Line train in 18 minutes.

Next Orange Line train in 18 minutes.

10:42 am

>wait
Time passes.

Next Green Line train in 13 minutes.

Next Blue Line train in 21 minutes.

Next Orange Line train in 18 minutes.

10:43 am

>wait
Time passes.

Next Green Line train in 12 minutes.

Next Blue Line train in 20 minutes.

Next Orange Line train in 18 minutes.

10:44 am

>wait
Time passes.

Next Green Line train in 12 minutes.

Next Blue Line train in 20 minutes.

Next Orange Line train in 18 minutes.

10:45 am

>wait
Time passes.

Next Green Line train in 15 minutes.

Next Blue Line train in 19 minutes.

Next Orange Line train in 18 minutes.

10:46 am

>wait
Time passes.

Next Green Line train in 14 minutes.

Next Blue Line train in 18 minutes.

Next Orange Line train in 18 minutes.

10:47 am

>wait
Time passes.

Next Green Line train in 14 minutes.

Next Blue Line train in 18 minutes.

Next Orange Line train in 18 minutes.

10:48 am

>look
Lake Merritt
You are on a BART platform.

You can see an elevator (empty) here.

Next Green Line train in 17 minutes.

Next Blue Line train in 17 minutes.

Next Orange Line train in 18 minutes.

10:49 am

>look
Lake Merritt
You are on a BART platform.

You can see an elevator (empty) here.

Next Green Line train in 16 minutes.

Next Blue Line train in 16 minutes.

Next Orange Line train in 18 minutes.

10:50 am

* * *

Transitory
An Interactive Fiction by lizzard
Release 1 / Serial number 190126 / Inform 7 build 6M62 (I6/v6.33 lib 6/12N) SD

Mission 24th St
You are underground, on a BART platform. The hollow sound of vibrating train rails echoes through the station. Boxy concrete arches run overhead and then frame the sides of the train tunnel. If you look around, you will probably find the elevator. On the platform itself, the floor is covered with long brick-red tiles, while the median walls are tiled in muted orange, gold, and brown, like a desert sunset.

9:00 am

>look at flower seller
A short, smiling woman in a baseball hat and a red checked scarf pushes  her wheely cart full of roses and carnations. Her jacket has a ladybug pin.

A flower seller beams at you with a huge happy grin.

>d
You can't go that way.

A flower seller shares a coffee with a friend.

>l
Calle 24 Southwest Plaza
Little tables and tent-covered booths are scattered throughout this busy plaza, with people selling souvenirs from Mexico and Guatemala, shopping bags, embroidered huipil blouses, woolen ponchos, phone chargers and cases, jewelry, and flowers. Many kinds of music are playing here - norteo blasts its cheerful accordions from speakers at a booth, saxophone notes float up from the huge, round stairwell which goes down to the station, songs blare from passing cars. There is a sloping area useful as a stage underneath the Coffee and Mission mural to the west.

You can see a flower seller here.

A flower seller called out, "Flores!"
.

>n
Calle 24 Northwest Corner
This lively streetcorner just outside the Chinese Food and Donuts shop has buses pulling up along 24th Street, many cars going by, people crossing the street and just standing around, music blaring from passing cars and from the shops all around. Along Mission, tall washingtonia palms spring into the sky.

* * *

>look at flower seller
A short, smiling woman in a baseball hat and a red checked scarf pushes  her wheely cart full of roses and carnations. Her jacket has a ladybug pin.

A flower seller beams at you with a huge happy grin.

>l
Calle 24 Southwest Plaza
Little tables and tent-covered booths are scattered throughout this busy plaza, with people selling souvenirs from Mexico and Guatemala, shopping bags, embroidered huipil blouses, woolen ponchos, phone chargers and cases, jewelry, and flowers. Many kinds of music are playing here - norteo blasts its cheerful accordions from speakers at a booth, saxophone notes float up from the huge, round stairwell which goes down to the station, songs blare from passing cars. There is a sloping area useful as a stage underneath the Coffee and Mission mural. Across 24th street to the north, there's a donut shop.

You can see a flower seller here.

A flower seller offers you a little bunch of carnations tied with string.

>n
Calle 24 Northwest Corner
This lively streetcorner just outside the Chinese Food and Donuts shop has buses pulling up along 24th Street, many cars going by, people crossing the street and just standing around, music blaring from passing cars and from the shops all around. Along Mission, tall washingtonia palms spring into the sky.

* * *

>look at flower seller
A short, smiling woman in a baseball hat and a red checked scarf pushes  her wheely cart full of roses and carnations. Her jacket has a ladybug pin.

A flower seller beams at you with a huge happy grin.

>smile at flower seller
That's not a verb I recognise.

>north
Calle 24 Northwest Corner
Just outside the Chinese Food and Donuts shop, this lively streetcorner has buses pulling up along 24th Street, many cars going by, people crossing the street and just standing around, music blaring from passing cars and from the shops all around. Along Mission, high overhead, washingtonia palms stretch into the sky. To the east, there's another BART plaza with an elevator.

>e
Calle 24 Northeast Plaza
Palm trees sway high overhead. Delicate metal rails surround the enormous circular stairwell that goes down to the station concourse. All around you are little shops, restaurants, taquerias, people talking, buses pulling up to the stops on Mission and on 24th Street, music blasting from cars going by. A huge mural runs across the wall of the taqueria bordering the plaza to the north, of a gleaming BART train carried on the backs of determined workers amid a geometric cityscape.

You can see a tamale lady and a yelling preacher here.

A tamale lady watches the people passing by.

If you look around past the crowds you might find the elevator.

>look at yelling preacher
A short man yells fervently in Spanish into a microphone. You recognize some things from the Bible, though it is hard to understand him from the low quality amp at his feet.

A tamale lady shifts her weight from one foot to the other.

>buy tamale
Nothing is on sale.

A tamale lady shifts her weight from one foot to the other.

>look
Calle 24 Northeast Plaza
Palm trees sway high overhead. Delicate metal rails surround the enormous circular stairwell that goes down to the station concourse. All around you are little shops, restaurants, taquerias, people talking, buses pulling up to the stops on Mission and on 24th Street, music blasting from cars going by. A huge mural runs across the wall of the taqueria bordering the plaza to the north, of a gleaming BART train carried on the backs of determined workers amid a geometric cityscape.

You can see an elevator (empty), a tamale lady and a yelling preacher here.

A tamale lady says "Tamales!"
.

>enter elevator
You get into the elevator. The doors close. Best to go up or down as fast as possible to get out of the stench.

A tamale lady smiles at you.

>look
Calle 24 Northeast Plaza (in the elevator)
Palm trees sway high overhead. Delicate metal rails surround the enormous circular stairwell that goes down to the station concourse. All around you are little shops, restaurants, taquerias, people talking, buses pulling up to the stops on Mission and on 24th Street, music blasting from cars going by. A huge mural runs across the wall of the taqueria bordering the plaza to the north, of a gleaming BART train carried on the backs of determined workers amid a geometric cityscape.

You can see a tamale lady and a yelling preacher here.

A tamale lady says "Tamales!"
.

>down
The elevator almost imperceptibly moves down. Time passes. You smell a lot of things, wishing you couldn't. The doors open again.

Mission 24th Concourse (in the elevator)
Enormous concrete buttresses soar overhead, like a futuristic 70s airplane hangar. Music echoes hauntingly from a monumental stairwell rising up to the plaza, combining with the wild harmonics of trains below. There is an elevator to the platform to the north, and another elevator to the street to the northwest.

>exits
That's not a verb I recognise.

>n
You can't go that way.

>e
You can't go that way.

>w
You can't go that way.

>s
You can't go that way.

>out
You get out of the elevator.

Mission 24th Concourse
Enormous concrete buttresses soar overhead, like a futuristic 70s airplane hangar. Music echoes hauntingly from a monumental stairwell rising up to the plaza, combining with the wild harmonics of trains below. There is an elevator to the platform to the north, and another elevator to the street to the northwest.

You can see an elevator (empty) here.

>look north
You see nothing unexpected in that direction.

>enter elevator
You get into the elevator. The doors close. Best to go up or down as fast as possible to get out of the stench.

>down
The elevator almost imperceptibly moves down. Time passes. You smell a lot of things, wishing you couldn't. The doors open again.

Mission 24th St (in the elevator)
You are underground, on a BART platform. The hollow sound of vibrating train rails echoes through the station. Boxy concrete arches run overhead and then frame the sides of the train tunnel. An elevator is in the median wall to the north. On the platform itself, the floor is covered with long brick-red tiles, while the median walls are tiled in muted orange, gold, and brown, like a desert sunset.

>look
Mission 24th St (in the elevator)
You are underground, on a BART platform. The hollow sound of vibrating train rails echoes through the station. Boxy concrete arches run overhead and then frame the sides of the train tunnel. An elevator is in the median wall to the north. On the platform itself, the floor is covered with long brick-red tiles, while the median walls are tiled in muted orange, gold, and brown, like a desert sunset.

>n
You can't go that way.

* * *

>s
You can't go that way.

>out
You get out of the elevator.

Mission 24th St
You are underground, on a BART platform. The hollow sound of vibrating train rails echoes through the station. Boxy concrete arches run overhead and then frame the sides of the train tunnel. An elevator is in the median wall to the north. On the platform itself, the floor is covered with long brick-red tiles, while the median walls are tiled in muted orange, gold, and brown, like a desert sunset.

You can see an elevator (empty) here.

>w
You can't go that way.

>e
You can't go that way.

>s
You can't go that way.

>w
You can't go that way.

>n
You can't go that way.

>look
Mission 24th St
You are underground, on a BART platform. The hollow sound of vibrating train rails echoes through the station. Boxy concrete arches run overhead and then frame the sides of the train tunnel. An elevator is in the median wall to the north. On the platform itself, the floor is covered with long brick-red tiles, while the median walls are tiled in muted orange, gold, and brown, like a desert sunset.

You can see an elevator (empty) here.

>l
Mission 24th St
You are underground, on a BART platform. The hollow sound of vibrating train rails echoes through the station. Boxy concrete arches run overhead and then frame the sides of the train tunnel. An elevator is in the median wall to the north. On the platform itself, the floor is covered with long brick-red tiles, while the median walls are tiled in muted orange, gold, and brown, like a desert sunset.

You can see an elevator (empty) here.

>l
Mission 24th St
You are underground, on a BART platform. The hollow sound of vibrating train rails echoes through the station. Boxy concrete arches run overhead and then frame the sides of the train tunnel. An elevator is in the median wall to the north. On the platform itself, the floor is covered with long brick-red tiles, while the median walls are tiled in muted orange, gold, and brown, like a desert sunset.

You can see an elevator (empty) here.

>wait
Time passes.

>l
Mission 24th St
You are underground, on a BART platform. The hollow sound of vibrating train rails echoes through the station. Boxy concrete arches run overhead and then frame the sides of the train tunnel. An elevator is in the median wall to the north. On the platform itself, the floor is covered with long brick-red tiles, while the median walls are tiled in muted orange, gold, and brown, like a desert sunset.

You can see an elevator (empty) here.

>look at timetable
You can't see any such thing.

>enter elevator
You get into the elevator. The doors close. Best to go up or down as fast as possible to get out of the stench.

>up
 The elevator almost imperceptibly moves up. Time passes. You smell a lot of things, wishing you couldn't. The doors open again.

Mission 24th Concourse (in the elevator)
Enormous concrete buttresses soar overhead, like a futuristic 70s airplane hangar. Music echoes hauntingly from a monumental stairwell rising up to the plaza, combining with the wild harmonics of trains below. There is an elevator to the platform to the north, and another elevator to the street to the northwest.

>out
You get out of the elevator.

Mission 24th Concourse
Enormous concrete buttresses soar overhead, like a futuristic 70s airplane hangar. Music echoes hauntingly from a monumental stairwell rising up to the plaza, combining with the wild harmonics of trains below. There is an elevator to the platform to the north, and another elevator to the street to the northwest.

You can see an elevator (empty) here.

>down
Quite challenging, since your wheels won't make it down the stairs.

* * *

Transitory
An Interactive Fiction by lizzard
Release 1 / Serial number 190126 / Inform 7 build 6M62 (I6/v6.33 lib 6/12N) SD

Mission 24th St
You are underground, on a BART platform. The hollow sound of vibrating train rails echoes through the station. Boxy concrete arches run overhead and then frame the sides of the train tunnel. If you look around, you will probably find the elevator. On the platform itself, the floor is covered with long brick-red tiles, while the median walls are tiled in muted orange, gold, and brown, like a desert sunset.

9:00 am

>n
Calle 24 Northwest Corner
Just outside the Chinese Food and Donuts shop, this lively streetcorner has buses pulling up along 24th Street, many cars going by, people crossing the street and just standing around, music blaring from passing cars and from the shops all around. Along Mission, high overhead, washingtonia palms stretch into the sky. To the east, there's another BART plaza with an elevator.

9:01 am

>e
Calle 24 Northeast Plaza
Palm trees sway high overhead. Delicate metal rails surround the enormous circular stairwell that goes down to the station concourse. All around you are little shops, restaurants, taquerias, people talking, buses pulling up to the stops on Mission and on 24th Street, music blasting from cars going by. A huge mural runs across the wall of the taqueria bordering the plaza to the north, of a gleaming BART train carried on the backs of determined workers amid a geometric cityscape.

You can see a tamale lady and a yelling preacher here.

A tamale lady watches the people passing by.

If you look around past the crowds you might find the elevator.

9:02 am

I beg your pardon?

9:02 am

>l
Calle 24 Northeast Plaza
Palm trees sway high overhead. Delicate metal rails surround the enormous circular stairwell that goes down to the station concourse. All around you are little shops, restaurants, taquerias, people talking, buses pulling up to the stops on Mission and on 24th Street, music blasting from cars going by. A huge mural runs across the wall of the taqueria bordering the plaza to the north, of a gleaming BART train carried on the backs of determined workers amid a geometric cityscape.

You can see an elevator (empty), a tamale lady and a yelling preacher here.

A tamale lady says "Tamales!"
.

9:03 am

>enter
You get into the elevator. The doors close. Best to go up or down as fast as possible to get out of the stench.

A tamale lady watches the people passing by.

9:04 am

>d
The elevator almost imperceptibly moves down. Time passes. You smell a lot of things, wishing you couldn't. The doors open again.

Mission 24th Concourse (in the elevator)
Enormous concrete buttresses soar overhead, like a futuristic 70s airplane hangar. Music echoes hauntingly from a monumental stairwell rising up to the plaza, combining with the wild harmonics of trains below. 

9:05 am

>d
The elevator almost imperceptibly moves down. Time passes. You smell a lot of things, wishing you couldn't. The doors open again.

Mission 24th St (in the elevator)
You are underground, on a BART platform. The hollow sound of vibrating train rails echoes through the station. Boxy concrete arches run overhead and then frame the sides of the train tunnel. An elevator is in the median wall to the north. On the platform itself, the floor is covered with long brick-red tiles, while the median walls are tiled in muted orange, gold, and brown, like a desert sunset.

You can see a Green Line train and a Blue Line train here.

The Red line train is in El Cerrito del Norte. The number of stops on the Red Line train is 38
9:06 am

>exit
You get out of the elevator.

Mission 24th St
You are underground, on a BART platform. The hollow sound of vibrating train rails echoes through the station. Boxy concrete arches run overhead and then frame the sides of the train tunnel. An elevator is in the median wall to the north. On the platform itself, the floor is covered with long brick-red tiles, while the median walls are tiled in muted orange, gold, and brown, like a desert sunset.

You can see an elevator (empty), a Green Line train and a Blue Line train here.

The door of the Blue Line train closes.

The Blue Line train sets off.
The door of the Green Line train closes.

The Green Line train sets off.

The Red line train is in Transitional Location. The number of stops on the Red Line train is 38
9:07 am

* * *

>l
Calle 24 Northeast Plaza
Palm trees sway high overhead. Delicate metal rails surround the enormous circular stairwell that goes down to the station concourse. All around you are little shops, restaurants, taquerias, people talking, buses pulling up to the stops on Mission and on 24th Street, music blasting from cars going by. A huge mural runs across the wall of the taqueria bordering the plaza to the north, of a gleaming BART train carried on the backs of determined workers amid a geometric cityscape.

You can see an elevator (empty), a tamale lady and a yelling preacher here.

A tamale lady says "Tamales!"
.

9:03 am

>enter
You get into the elevator. The doors close. Best to go up or down as fast as possible to get out of the stench.

A tamale lady says "Tamales de pollo!"
.

9:04 am

>d
The elevator almost imperceptibly moves down. Time passes. You smell a lot of things, wishing you couldn't. The doors open again.

Mission 24th Concourse (in the elevator)
Enormous concrete buttresses soar overhead, like a futuristic 70s airplane hangar. Music echoes hauntingly from a monumental stairwell rising up to the plaza, combining with the wild harmonics of trains below. 

9:05 am

>d
The elevator almost imperceptibly moves down. Time passes. You smell a lot of things, wishing you couldn't. The doors open again.

Mission 24th St (in the elevator)
You are underground, on a BART platform. The hollow sound of vibrating train rails echoes through the station. Boxy concrete arches run overhead and then frame the sides of the train tunnel. An elevator is in the median wall to the north. On the platform itself, the floor is covered with long brick-red tiles, while the median walls are tiled in muted orange, gold, and brown, like a desert sunset.

You can see a Green Line train and a Blue Line train here.

The Red line train is in El Cerrito del Norte
9:06 am

>enter green train
(getting out of the elevator)
You get into the Green Line train.

The door of the Blue Line train closes.

The Blue Line train sets off.
The door closes.

The Green Line train starts moving again.

9:07 am

>l
The Green Line train
The Green Line train stops at Embarcadero. The door opens.

9:08 am

>l
Embarcadero (in the Green Line train)
You are on a BART platform underground. Lots of people are around and there are muffled announcements over an intercom.

You can see a Blue Line train and a Yellow Line train here.

9:09 am

>l
Embarcadero (in the Green Line train)
You are on a BART platform underground. Lots of people are around and there are muffled announcements over an intercom.

You can see a Blue Line train and a Yellow Line train here.

The door of the Yellow Line train closes.

The Yellow Line train sets off.
The door of the Blue Line train closes.

The Blue Line train sets off.
The door closes.

The Green Line train starts moving again.

9:10 am

>l
The Green Line train
The Green Line train stops at West Oakland. The door opens.

9:11 am

>l
West Oakland (in the Green Line train)
You are underground, on a BART platform. Sounds of trains are all around you.

You can see a Blue Line train here.

9:12 am

>l
West Oakland (in the Green Line train)
You are underground, on a BART platform. Sounds of trains are all around you.

You can see a Blue Line train here.

The door of the Blue Line train closes.

The Blue Line train sets off.
The door closes.

The Green Line train starts moving again.

9:13 am

>l
The Green Line train
The Green Line train stops at Warm Springs/South Fremont. The door opens.

9:14 am

>l
Warm Springs/South Fremont (in the Green Line train)
You are on a BART platform in the unknown reaches of outer Fremont.

9:15 am

>l
Warm Springs/South Fremont (in the Green Line train)
You are on a BART platform in the unknown reaches of outer Fremont.

The door closes.

The Green Line train starts moving again.

9:16 am

>l
The Green Line train
The Green Line train stops at West Oakland. The door opens.

9:17 am

>l
West Oakland (in the Green Line train)
You are underground, on a BART platform. Sounds of trains are all around you.

You can see a Blue Line train here.

9:18 am

>l
West Oakland (in the Green Line train)
You are underground, on a BART platform. Sounds of trains are all around you.

You can see a Blue Line train here.

The door of the Blue Line train closes.

The Blue Line train sets off.
The door closes.

The Green Line train starts moving again.

9:19 am

>l
The Green Line train
The Green Line train stops at Embarcadero. The door opens.

9:20 am

>l
Embarcadero (in the Green Line train)
You are on a BART platform underground. Lots of people are around and there are muffled announcements over an intercom.

You can see a Blue Line train and a Yellow Line train here.

9:21 am

>l
Embarcadero (in the Green Line train)
You are on a BART platform underground. Lots of people are around and there are muffled announcements over an intercom.

You can see a Blue Line train and a Yellow Line train here.

The door of the Yellow Line train closes.

The Yellow Line train sets off.
The door of the Blue Line train closes.

The Blue Line train sets off.
The door closes.

The Green Line train starts moving again.

9:22 am

>l
The Green Line train
The Green Line train stops at Mission 24th St. The door opens.

9:23 am

>exit
You get out of the Green Line train.

Mission 24th St
You are underground, on a BART platform. The hollow sound of vibrating train rails echoes through the station. Boxy concrete arches run overhead and then frame the sides of the train tunnel. An elevator is in the median wall to the north. On the platform itself, the floor is covered with long brick-red tiles, while the median walls are tiled in muted orange, gold, and brown, like a desert sunset.

You can see a Green Line train, a Blue Line train and an elevator (empty) here.

9:24 am

* * *

>l
Mission 24th St (in the elevator)
You are underground, on a BART platform. The hollow sound of vibrating train rails echoes through the station. Boxy concrete arches run overhead and then frame the sides of the train tunnel. An elevator is in the median wall to the north. On the platform itself, the floor is covered with long brick-red tiles, while the median walls are tiled in muted orange, gold, and brown, like a desert sunset.

You can see a Green Line train and a Blue Line train here.

The door of the Blue Line train closes.

The Blue Line train sets off.
The door of the Green Line train closes.

The Green Line train sets off.

The Red line train is in Transitional Location
9:07 am

>l
Mission 24th St (in the elevator)
You are underground, on a BART platform. The hollow sound of vibrating train rails echoes through the station. Boxy concrete arches run overhead and then frame the sides of the train tunnel. An elevator is in the median wall to the north. On the platform itself, the floor is covered with long brick-red tiles, while the median walls are tiled in muted orange, gold, and brown, like a desert sunset.

The Red line train is in El Cerrito Plaza
9:08 am

>l
Mission 24th St (in the elevator)
You are underground, on a BART platform. The hollow sound of vibrating train rails echoes through the station. Boxy concrete arches run overhead and then frame the sides of the train tunnel. An elevator is in the median wall to the north. On the platform itself, the floor is covered with long brick-red tiles, while the median walls are tiled in muted orange, gold, and brown, like a desert sunset.

The Red line train is in El Cerrito Plaza
9:09 am

>l
Mission 24th St (in the elevator)
You are underground, on a BART platform. The hollow sound of vibrating train rails echoes through the station. Boxy concrete arches run overhead and then frame the sides of the train tunnel. An elevator is in the median wall to the north. On the platform itself, the floor is covered with long brick-red tiles, while the median walls are tiled in muted orange, gold, and brown, like a desert sunset.

The Red line train is in Transitional Location
9:10 am

>l
Mission 24th St (in the elevator)
You are underground, on a BART platform. The hollow sound of vibrating train rails echoes through the station. Boxy concrete arches run overhead and then frame the sides of the train tunnel. An elevator is in the median wall to the north. On the platform itself, the floor is covered with long brick-red tiles, while the median walls are tiled in muted orange, gold, and brown, like a desert sunset.

The Yellow Line train pulls up. The door opens.

The Red line train is in North Berkeley
9:11 am

>l
Mission 24th St (in the elevator)
You are underground, on a BART platform. The hollow sound of vibrating train rails echoes through the station. Boxy concrete arches run overhead and then frame the sides of the train tunnel. An elevator is in the median wall to the north. On the platform itself, the floor is covered with long brick-red tiles, while the median walls are tiled in muted orange, gold, and brown, like a desert sunset.

You can see a Yellow Line train here.

The Red line train is in North Berkeley
9:12 am

>l
Mission 24th St (in the elevator)
You are underground, on a BART platform. The hollow sound of vibrating train rails echoes through the station. Boxy concrete arches run overhead and then frame the sides of the train tunnel. An elevator is in the median wall to the north. On the platform itself, the floor is covered with long brick-red tiles, while the median walls are tiled in muted orange, gold, and brown, like a desert sunset.

You can see a Yellow Line train here.

The door of the Yellow Line train closes.

The Yellow Line train sets off.

The Red line train is in Transitional Location
9:13 am

>l
Mission 24th St (in the elevator)
You are underground, on a BART platform. The hollow sound of vibrating train rails echoes through the station. Boxy concrete arches run overhead and then frame the sides of the train tunnel. An elevator is in the median wall to the north. On the platform itself, the floor is covered with long brick-red tiles, while the median walls are tiled in muted orange, gold, and brown, like a desert sunset.

The Red line train is in Downtown Berkeley
9:14 am

* * *

>enter
You get into the elevator. The doors close. Best to go up or down as fast as possible to get out of the stench.

A tamale lady says "Tamales de pollo!"
.

9:04 am

>push p button
Nothing obvious happens.

A tamale lady says "Tamales de carne!"
.

* * *

>in
You can't go that way.

A tamale lady says "Tamales!"
.

9:04 am

>d
Quite challenging, since your wheels won't make it down the stairs.

A tamale lady shifts her weight from one foot to the other.

9:05 am

>enter
You get into the elevator. The doors close. Best to go up or down as fast as possible to get out of the stench.

A tamale lady watches the people passing by.

9:06 am

>d
The elevator almost imperceptibly moves down. Time passes. You smell a lot of things, wishing you couldn't. The doors open again.

Mission 24th Concourse (in the elevator)
Enormous concrete buttresses soar overhead, like a futuristic 70s airplane hangar. Music echoes hauntingly from a monumental stairwell rising up to the plaza, combining with the wild harmonics of trains below. 

9:07 am

>d
The elevator almost imperceptibly moves down. Time passes. You smell a lot of things, wishing you couldn't. The doors open again.

Mission 24th St (in the elevator)
You are underground, on a BART platform. The hollow sound of vibrating train rails echoes through the station. Boxy concrete arches run overhead and then frame the sides of the train tunnel. An elevator is in the median wall to the north. On the platform itself, the floor is covered with long brick-red tiles, while the median walls are tiled in muted orange, gold, and brown, like a desert sunset.

9:08 am

>exit
You get out of the elevator.

Mission 24th St
You are underground, on a BART platform. The hollow sound of vibrating train rails echoes through the station. Boxy concrete arches run overhead and then frame the sides of the train tunnel. An elevator is in the median wall to the north. On the platform itself, the floor is covered with long brick-red tiles, while the median walls are tiled in muted orange, gold, and brown, like a desert sunset.

You can see an elevator (empty) here.

9:09 am

* * *

>s
Calle 24 Southeast Corner
This busy street corner by the McDonalds is grimy. It's basically a crowded spot where people wait to cross the street. Across Mission to the west, there's a nice plaza with a busy market. Across 24th Street to the north, another lovely plaza with musicians, preachers, and some places to sit.

You can see a raccoon here.

A raccoon hauls itsef out of a concrete trash bin.

>n
Calle 24 Northeast Plaza
Palm trees sway high overhead. Delicate metal rails surround the enormous circular stairwell that goes down to the station concourse. All around you are little shops, restaurants, taquerias, people talking, buses pulling up to the stops on Mission and on 24th Street, music blasting from cars going by. A huge mural runs across the wall of the taqueria bordering the plaza to the north, of a gleaming BART train carried on the backs of determined workers amid a geometric cityscape.

You can see an elevator (empty), a tamale lady and a yelling preacher here.

A tamale lady says "Tamales!"
.

* * *

>search
What do you want to search?

>l
Calle 24 Northeast Plaza
Palm trees sway high overhead. Delicate metal rails surround the enormous circular stairwell that goes down to the station concourse. All around you are little shops, restaurants, taquerias, people talking, buses pulling up to the stops on Mission and on 24th Street, music blasting from cars going by. A huge mural runs across the wall of the taqueria bordering the plaza to the north, of a gleaming BART train carried on the backs of determined workers amid a geometric cityscape.

You can see an elevator (empty), a tamale lady and a yelling preacher here.

A tamale lady shifts her weight from one foot to the other.

>in
You can't go that way.

A tamale lady says "Tamales!"
.

>enter elevator
You get into the elevator. The doors close. Best to go up or down as fast as possible to get out of the stench.

A tamale lady watches the people passing by.

>up
You can't go that way.

A tamale lady watches the people passing by.

>d
The elevator almost imperceptibly moves down. Time passes. You smell a lot of things, wishing you couldn't. The doors open again.

Mission 24th Concourse (in the elevator)
Enormous concrete buttresses soar overhead, like a futuristic 70s airplane hangar. Music echoes hauntingly from a monumental stairwell rising up to the plaza, combining with the wild harmonics of trains below. There is an elevator to the platform to the north, and another elevator to the street to the northwest.

>d
The elevator almost imperceptibly moves down. Time passes. You smell a lot of things, wishing you couldn't. The doors open again.

Mission 24th St (in the elevator)
You are underground, on a BART platform. The hollow sound of vibrating train rails echoes through the station. Boxy concrete arches run overhead and then frame the sides of the train tunnel. An elevator is in the median wall to the north. On the platform itself, the floor is covered with long brick-red tiles, while the median walls are tiled in muted orange, gold, and brown, like a desert sunset.

>exit
You get out of the elevator.

Mission 24th St
You are underground, on a BART platform. The hollow sound of vibrating train rails echoes through the station. Boxy concrete arches run overhead and then frame the sides of the train tunnel. An elevator is in the median wall to the north. On the platform itself, the floor is covered with long brick-red tiles, while the median walls are tiled in muted orange, gold, and brown, like a desert sunset.

You can see an elevator (empty) here.

>l
Mission 24th St
You are underground, on a BART platform. The hollow sound of vibrating train rails echoes through the station. Boxy concrete arches run overhead and then frame the sides of the train tunnel. An elevator is in the median wall to the north. On the platform itself, the floor is covered with long brick-red tiles, while the median walls are tiled in muted orange, gold, and brown, like a desert sunset.

You can see an elevator (empty) here.

* * *

>n
Calle 24 Northwest Corner
Just outside the Chinese Food and Donuts shop, this lively streetcorner has buses pulling up along 24th Street, many cars going by, people crossing the street and just standing around, music blaring from passing cars and from the shops all around. Along Mission, high overhead, washingtonia palms stretch into the sky. To the east, there's another BART plaza with an elevator.

9:01 am

>s
Mission 24th Concourse
Enormous concrete buttresses soar overhead, like a futuristic 70s airplane hangar. Music echoes hauntingly from a monumental stairwell rising up to the plaza, combining with the wild harmonics of trains below. There is an elevator to the platform to the north, and another elevator to the street to the northwest.

>n
The doors slowly close. The elevator almost imperceptibly moves. Time passes. You smell a lot of things, wishing you couldn't. The doors open again, looking south.

Mission 24th Platform Elevator
The elevator is grimy and smells like pee.

>n
Mission 24th Concourse
Enormous concrete buttresses soar overhead, like a futuristic 70s airplane hangar. Music echoes hauntingly from a monumental stairwell rising up to the plaza, combining with the wild harmonics of trains below.

>l
Mission 24th Concourse
Enormous concrete buttresses soar overhead, like a futuristic 70s airplane hangar. Music echoes hauntingly from a monumental stairwell rising up to the plaza, combining with the wild harmonics of trains below.

>n
The doors slowly close. The elevator almost imperceptibly moves. Time passes. You smell a lot of things, wishing you couldn't. The doors open again, looking south.

Mission 24th Platform Elevator

* * *

>n
The doors slowly close. The elevator almost imperceptibly moves. Time passes. You smell a lot of things, wishing you couldn't. The doors open again, looking south.

Mission 24th Platform Elevator
The elevator is grimy and smells like pee.

>s
Mission 24th St
You are underground, on a BART platform. The hollow sound of vibrating train rails echoes through the station. Boxy concrete arches run overhead and then frame the sides of the train tunnel. An elevator is in the median wall to the north. On the platform itself, the floor is covered with long brick-red tiles, while the median walls are tiled in muted orange, gold, and brown, like a desert sunset.

>n
The doors slowly close. The elevator almost imperceptibly moves. Time passes. You smell a lot of things, wishing you couldn't. The doors open again, looking south.

Mission 24th Platform Elevator
The elevator is grimy and smells like pee.

>nw
You can't go that way.

>ne
You can't go that way.

>s
Mission 24th Concourse
Enormous concrete buttresses soar overhead, like a futuristic 70s airplane hangar. Music echoes hauntingly from a monumental stairwell rising up to the plaza, combining with the wild harmonics of trains below. There is an elevator to the platform to the north, and another elevator to the street to the northwest.

* * *

>nw
The doors slowly close. The elevator almost imperceptibly moves. Time passes. You smell a lot of things, wishing you couldn't. The doors open again, looking southeast.

Mission 24th Street Elevator

>se
Calle 24 Northeast Plaza
Palm trees sway high overhead. Delicate metal rails surround the enormous circular stairwell that goes down to the station concourse. All around you are little shops, restaurants, taquerias, people talking, buses pulling up to the stops on Mission and on 24th Street, music blasting from cars going by. A huge mural runs across the wall of the taqueria bordering the plaza to the north, of a gleaming BART train carried on the backs of determined workers amid a geometric cityscape.

You can see a tamale lady and a yelling preacher here.

A tamale lady shifts her weight from one foot to the other.

* * *

Transitory
An Interactive Fiction by lizzard
Release 1 / Serial number 190126 / Inform 7 build 6M62 (I6/v6.33 lib 6/12N) SD

Mission 24th St
You are underground, on a BART platform. The hollow sound of vibrating train rails echoes through the station. Boxy concrete arches run overhead and then frame the sides of the train tunnel. If you look around, you will probably find the elevator. On the platform itself, the floor is covered with long brick-red tiles, while the median walls are tiled in muted orange, gold, and brown, like a desert sunset.

9:00 am

>nw
You can't go that way.

>n
The doors slowly close. The elevator almost imperceptibly moves. Time passes. You smell a lot of things, wishing you couldn't. The doors open again, looking south.

Mission 24th Platform Elevator

>l
Mission 24th Platform Elevator

>s
Mission 24th St
You are underground, on a BART platform. The hollow sound of vibrating train rails echoes through the station. Boxy concrete arches run overhead and then frame the sides of the train tunnel. An elevator is in the median wall to the north. On the platform itself, the floor is covered with long brick-red tiles, while the median walls are tiled in muted orange, gold, and brown, like a desert sunset.

>l
Mission 24th St
You are underground, on a BART platform. The hollow sound of vibrating train rails echoes through the station. Boxy concrete arches run overhead and then frame the sides of the train tunnel. An elevator is in the median wall to the north. On the platform itself, the floor is covered with long brick-red tiles, while the median walls are tiled in muted orange, gold, and brown, like a desert sunset.

>n
The doors slowly close. The elevator almost imperceptibly moves. Time passes. You smell a lot of things, wishing you couldn't. The doors open again, looking south.

Mission 24th Platform Elevator

>s
Mission 24th St
You are underground, on a BART platform. The hollow sound of vibrating train rails echoes through the station. Boxy concrete arches run overhead and then frame the sides of the train tunnel. An elevator is in the median wall to the north. On the platform itself, the floor is covered with long brick-red tiles, while the median walls are tiled in muted orange, gold, and brown, like a desert sunset.

>n
The doors slowly close. The elevator almost imperceptibly moves. Time passes. You smell a lot of things, wishing you couldn't. The doors open again, looking south.

Mission 24th Platform Elevator

>n
Mission 24th St
You are underground, on a BART platform. The hollow sound of vibrating train rails echoes through the station. Boxy concrete arches run overhead and then frame the sides of the train tunnel. An elevator is in the median wall to the north. On the platform itself, the floor is covered with long brick-red tiles, while the median walls are tiled in muted orange, gold, and brown, like a desert sunset.

>n
The doors slowly close. The elevator almost imperceptibly moves. Time passes. You smell a lot of things, wishing you couldn't. The doors open again, looking south.

Mission 24th Platform Elevator

>s
Mission 24th St
You are underground, on a BART platform. The hollow sound of vibrating train rails echoes through the station. Boxy concrete arches run overhead and then frame the sides of the train tunnel. An elevator is in the median wall to the north. On the platform itself, the floor is covered with long brick-red tiles, while the median walls are tiled in muted orange, gold, and brown, like a desert sunset.

The Red Line train pulls up. The door opens.

>n
The doors slowly close. The elevator almost imperceptibly moves. Time passes. You smell a lot of things, wishing you couldn't. The doors open again, looking south.

Mission 24th Platform Elevator

>n
Mission 24th St
You are underground, on a BART platform. The hollow sound of vibrating train rails echoes through the station. Boxy concrete arches run overhead and then frame the sides of the train tunnel. An elevator is in the median wall to the north. On the platform itself, the floor is covered with long brick-red tiles, while the median walls are tiled in muted orange, gold, and brown, like a desert sunset.

You can see a Red Line train here.

The door of the Red Line train closes.

The Red Line train sets off.

>l
Mission 24th St
You are underground, on a BART platform. The hollow sound of vibrating train rails echoes through the station. Boxy concrete arches run overhead and then frame the sides of the train tunnel. An elevator is in the median wall to the north. On the platform itself, the floor is covered with long brick-red tiles, while the median walls are tiled in muted orange, gold, and brown, like a desert sunset.

* * *

>l
Mission 24th Platform Elevator

>s
Mission 24th St
You are underground, on a BART platform. The hollow sound of vibrating train rails echoes through the station. Boxy concrete arches run overhead and then frame the sides of the train tunnel. An elevator is in the median wall to the north. On the platform itself, the floor is covered with long brick-red tiles, while the median walls are tiled in muted orange, gold, and brown, like a desert sunset.

The Red Line train pulls up. The door opens.

>up
Mission 24th Concourse
Enormous concrete buttresses soar overhead, like a futuristic 70s airplane hangar. Music echoes hauntingly from a monumental stairwell rising up to the plaza, combining with the wild harmonics of trains below. There is an elevator to the platform to the north, and another elevator to the street to the northwest.

>nw
The doors slowly close. The elevator almost imperceptibly moves. Time passes. You smell a lot of things, wishing you couldn't. The doors open again, looking southeast.

Mission 24th Street Elevator

>l
Mission 24th Street Elevator

>se
Mission 24th Concourse
Enormous concrete buttresses soar overhead, like a futuristic 70s airplane hangar. Music echoes hauntingly from a monumental stairwell rising up to the plaza, combining with the wild harmonics of trains below. There is an elevator to the platform to the north, and another elevator to the street to the northwest.

>nw
The doors slowly close. The elevator almost imperceptibly moves. Time passes. You smell a lot of things, wishing you couldn't. The doors open again, looking southeast.

Mission 24th Street Elevator

>s
You can't go that way.

>sw
You can't go that way.

>se
Mission 24th Concourse
Enormous concrete buttresses soar overhead, like a futuristic 70s airplane hangar. Music echoes hauntingly from a monumental stairwell rising up to the plaza, combining with the wild harmonics of trains below. There is an elevator to the platform to the north, and another elevator to the street to the northwest.

* * *

Transitory
An Interactive Fiction by lizzard
Release 1 / Serial number 190126 / Inform 7 build 6M62 (I6/v6.33 lib 6/12N) SD

Mission 24th St
You are underground, on a BART platform. The hollow sound of vibrating train rails echoes through the station. Boxy concrete arches run overhead and then frame the sides of the train tunnel. If you look around, you will probably find the elevator. On the platform itself, the floor is covered with long brick-red tiles, while the median walls are tiled in muted orange, gold, and brown, like a desert sunset.

9:00 am

>sit on chair
You can't see any such thing.

9:00 am

>sit on powerchair
You mount the snazzy black powerchair.

Next Yellow Line train in 7 minutes.

Next Red Line train in 31 minutes.

Next Green Line train in 3 minutes.

9:01 am

>look
Mission 24th St (on the snazzy black powerchair)
You are underground, on a BART platform. The hollow sound of vibrating train rails echoes through the station. Boxy concrete arches run overhead and then frame the sides of the train tunnel. If you look around, you will probably find the elevator. On the platform itself, the floor is covered with long brick-red tiles, while the median walls are tiled in muted orange, gold, and brown, like a desert sunset.

You can see an elevator (empty) here.

Next Yellow Line train in 6 minutes.

Next Red Line train in 30 minutes.

Next Green Line train in 2 minutes.

9:02 am

>enter
(getting off the snazzy black powerchair)
You get into the elevator. The doors close. Best to go up or down as fast as possible to get out of the stench.

Next Yellow Line train in 6 minutes.

Next Red Line train in 30 minutes.

Next Green Line train in 2 minutes.

9:03 am

>exit
You get out of the elevator.

Mission 24th St
You are underground, on a BART platform. The hollow sound of vibrating train rails echoes through the station. Boxy concrete arches run overhead and then frame the sides of the train tunnel. If you look around, you will probably find the elevator. On the platform itself, the floor is covered with long brick-red tiles, while the median walls are tiled in muted orange, gold, and brown, like a desert sunset.

You can see an elevator (empty) and a snazzy black powerchair here.

Next Yellow Line train in 5 minutes.

Next Red Line train in 29 minutes.

Next Green Line train in 1 minutes.

9:04 am

* * *

Transitory
An Interactive Fiction by lizzard
Release 1 / Serial number 190126 / Inform 7 build 6M62 (I6/v6.33 lib 6/12N) SD

Mission 24th St
You are underground, on a BART platform. The hollow sound of vibrating train rails echoes through the station. Boxy concrete arches run overhead and then frame the sides of the train tunnel. If you look around, you will probably find the elevator. On the platform itself, the floor is covered with long brick-red tiles, while the median walls are tiled in muted orange, gold, and brown, like a desert sunset.

9:00 am

>up
Mission 24th Concourse
Enormous concrete buttresses soar overhead, like a futuristic 70s airplane hangar. Music echoes hauntingly from a monumental stairwell rising up to the plaza, combining with the wild harmonics of trains below. There is an elevator to the platform to the north, and another elevator to the street to the northwest.

>kup
That's not a verb I recognise.

>up
Calle 24 Northeast Plaza
Palm trees sway high overhead. Delicate metal rails surround the enormous circular stairwell that goes down to the station concourse. All around you are little shops, restaurants, taquerias, people talking, buses pulling up to the stops on Mission and on 24th Street, music blasting from cars going by. A huge mural runs across the wall of the taqueria bordering the plaza to the north, of a gleaming BART train carried on the backs of determined workers amid a geometric cityscape.

You can see a tamale lady and a yelling preacher here.

A tamale lady says "Tamales de pollo!"
.

>e
You can't go that way.

A tamale lady says "Tamales!"
.

>s
Calle 24 Southeast Corner
This busy street corner by the McDonalds is grimy. It's basically a crowded spot where people wait to cross the street. Across Mission to the west, there's a nice plaza with a busy market. Across 24th Street to the north, another lovely plaza with musicians, preachers, and some places to sit.

You can see a raccoon here.

A raccoon hides in a little nook, eating some discarded fries.

>w
Calle 24 Southwest Plaza
Little tables and tent-covered booths are scattered throughout this busy plaza, with people selling souvenirs from Mexico and Guatemala, shopping bags, embroidered huipil blouses, woolen ponchos, phone chargers and cases, jewelry, and flowers. Many kinds of music are playing here - norteo blasts its cheerful accordions from speakers at a booth, saxophone notes float up from the huge, round stairwell which goes down to the station, songs blare from passing cars. There is a sloping area useful as a stage underneath the Coffee and Mission mural to the west.

You can see a flower seller here.

Mariquita fusses over her bunches of flowers, arranging thenm nicely.

* * *

>up
Mission 24th Concourse
Enormous concrete buttresses soar overhead, like a futuristic 70s airplane hangar. Music echoes hauntingly from a monumental stairwell rising up to the plaza, combining with the wild harmonics of trains below. There is an elevator to the platform to the north, and another elevator to the street to the northwest.

>up
Calle 24 Northeast Plaza
Palm trees sway high overhead. Delicate metal rails surround the enormous circular stairwell that goes down to the station concourse. All around you are little shops, restaurants, taquerias, people talking, buses pulling up to the stops on Mission and on 24th Street, music blasting from cars going by. A huge mural runs across the wall of the taqueria bordering the plaza to the north, of a gleaming BART train carried on the backs of determined workers amid a geometric cityscape.

You can see a tamale lady, a yelling preacher and a flower seller here.

A tamale lady says "Tamales de pollo!"
.

Mariquita fusses over her bunches of flowers, arranging thenm nicely.

>l
Calle 24 Northeast Plaza
Palm trees sway high overhead. Delicate metal rails surround the enormous circular stairwell that goes down to the station concourse. All around you are little shops, restaurants, taquerias, people talking, buses pulling up to the stops on Mission and on 24th Street, music blasting from cars going by. A huge mural runs across the wall of the taqueria bordering the plaza to the north, of a gleaming BART train carried on the backs of determined workers amid a geometric cityscape.

You can see a tamale lady and a yelling preacher here.

A tamale lady says "Tamales de pollo!"
.

>l
Calle 24 Northeast Plaza
Palm trees sway high overhead. Delicate metal rails surround the enormous circular stairwell that goes down to the station concourse. All around you are little shops, restaurants, taquerias, people talking, buses pulling up to the stops on Mission and on 24th Street, music blasting from cars going by. A huge mural runs across the wall of the taqueria bordering the plaza to the north, of a gleaming BART train carried on the backs of determined workers amid a geometric cityscape.

You can see a tamale lady and a yelling preacher here.

A tamale lady says "Tamales!"
.

>l
Calle 24 Northeast Plaza
Palm trees sway high overhead. Delicate metal rails surround the enormous circular stairwell that goes down to the station concourse. All around you are little shops, restaurants, taquerias, people talking, buses pulling up to the stops on Mission and on 24th Street, music blasting from cars going by. A huge mural runs across the wall of the taqueria bordering the plaza to the north, of a gleaming BART train carried on the backs of determined workers amid a geometric cityscape.

You can see a tamale lady and a yelling preacher here.

A tamale lady watches the people passing by.

>l
Calle 24 Northeast Plaza
Palm trees sway high overhead. Delicate metal rails surround the enormous circular stairwell that goes down to the station concourse. All around you are little shops, restaurants, taquerias, people talking, buses pulling up to the stops on Mission and on 24th Street, music blasting from cars going by. A huge mural runs across the wall of the taqueria bordering the plaza to the north, of a gleaming BART train carried on the backs of determined workers amid a geometric cityscape.

You can see a tamale lady and a yelling preacher here.

A tamale lady shifts her weight from one foot to the other.

>l
Calle 24 Northeast Plaza
Palm trees sway high overhead. Delicate metal rails surround the enormous circular stairwell that goes down to the station concourse. All around you are little shops, restaurants, taquerias, people talking, buses pulling up to the stops on Mission and on 24th Street, music blasting from cars going by. A huge mural runs across the wall of the taqueria bordering the plaza to the north, of a gleaming BART train carried on the backs of determined workers amid a geometric cityscape.

You can see a tamale lady and a yelling preacher here.

A tamale lady shifts her weight from one foot to the other.

* * *

>look at lady
A short, smiling woman in jeans and an army jacket stands next to a cooler on wheels.

* * *

>look at preacher
A short man yells in Spanish into a microphone. You recognize some things from the Bible though it is hard to understand him from the low quality amp at his feet.

A tamale lady says "Tamales!"
.

* * *

>s
Calle 24 Southeast Corner
This busy street corner by the McDonalds is grimy. It's basically a crowded spot where people wait to cross the street. Across Mission to the west, there's a nice plaza with a busy market. Across 24th Street to the north, another lovely plaza with musicians, preachers, and some places to sit.

You can see a raccoon here.

A raccoon skulks into a nearby alleyway.

>l
Calle 24 Southeast Corner
This busy street corner by the McDonalds is grimy. It's basically a crowded spot where people wait to cross the street. Across Mission to the west, there's a nice plaza with a busy market. Across 24th Street to the north, another lovely plaza with musicians, preachers, and some places to sit.

You can see a raccoon here.

A raccoon hauls itsef out of a concrete trash bin.

>l
Calle 24 Southeast Corner
This busy street corner by the McDonalds is grimy. It's basically a crowded spot where people wait to cross the street. Across Mission to the west, there's a nice plaza with a busy market. Across 24th Street to the north, another lovely plaza with musicians, preachers, and some places to sit.

You can see a raccoon here.

A raccoon skulks into a nearby alleyway.

>l
Calle 24 Southeast Corner
This busy street corner by the McDonalds is grimy. It's basically a crowded spot where people wait to cross the street. Across Mission to the west, there's a nice plaza with a busy market. Across 24th Street to the north, another lovely plaza with musicians, preachers, and some places to sit.

You can see a raccoon here.

A raccoon hauls itsef out of a concrete trash bin.

>l
Calle 24 Southeast Corner
This busy street corner by the McDonalds is grimy. It's basically a crowded spot where people wait to cross the street. Across Mission to the west, there's a nice plaza with a busy market. Across 24th Street to the north, another lovely plaza with musicians, preachers, and some places to sit.

You can see a raccoon here.

A raccoon hides in a little nook, eating some discarded fries.

* * *

>s
Calle 24 Southeast Corner
This busy street corner by the McDonalds is grimy. It's basically a crowded spot where people wait to cross the street. Across Mission to the west, there's a nice plaza with a busy market. Across 24th Street to the north, another lovely plaza with musicians, preachers, and some places to sit.

You can see a raccoon here.

A raccoon skulks into a nearby alleyway.

>s
You can't go that way.

A raccoon hauls itsef out of a concrete trash bin.

>w
Calle 24 Southwest Plaza
Little tables and tent-covered booths are scattered throughout this busy plaza, with people selling souvenirs from Mexico and Guatemala, shopping bags, embroidered huipil blouses, woolen ponchos, phone chargers and cases, jewelry, and flowers. Many kinds of music are playing here - norteo blasts its cheerful accordions from speakers at a booth, saxophone notes float up from the huge, round stairwell which goes down to the station, songs blare from passing cars. There is a sloping area useful as a stage underneath the Coffee and Mission mural to the west.

>n
Calle 24 Northwest Corner
This lively streetcorner just outside the Chinese Food and Donuts shop has buses pulling up along 24th Street, many cars going by, people crossing the street and just standing around, music blaring from passing cars and from the shops all around. Along Mission, tall washingtonia palms spring into the sky.

>n
You can't go that way.

>e
Calle 24 Northeast Plaza
Palm trees sway high overhead. Delicate metal rails surround the enormous circular stairwell that goes down to the station concourse. All around you are little shops, restaurants, taquerias, people talking, buses pulling up to the stops on Mission and on 24th Street, music blasting from cars going by. A huge mural runs across the wall of the taqueria bordering the plaza to the north, of a gleaming BART train carried on the backs of determined workers amid a geometric cityscape.

You can see a tamale lady and a yelling preacher here.

A tamale lady shifts her weight from one foot to the other.

* * *

>s
Calle 24 Southeast Corner
This busy street corner by the McDonalds is grimy. It's basically a crowded spot where people wait to cross the street. Across Mission to the west, there's a nice plaza with a busy market. Across 24th Street to the north, another lovely plaza with musicians, preachers, and some places to sit.

You can see a raccoon here.

A raccoon skulks into a nearby alleyway.

>w
Calle 24 Southwest Plaza

>n
Calle 24 Northwest Corner

>e
Calle 24 Northeast Plaza

* * *

Transitory
An Interactive Fiction by lizzard
Release 1 / Serial number 190126 / Inform 7 build 6M62 (I6/v6.33 lib 6/12N) SD

Mission 24th St
You are underground, on a BART platform. The hollow sound of vibrating train rails echoes through the station. Boxy concrete arches run overhead and then frame the sides of the train tunnel. If you look around, you will probably find the elevator. On the platform itself, the floor is covered with long brick-red tiles, while the median walls are tiled in muted orange, gold, and brown, like a desert sunset.

9:00 am

>wait
Time passes.

Next Yellow Line train in 7 minutes.

Next Red Line train in 31 minutes.

Next Green Line train in 7 minutes.

Next Blue Line train in 7 minutes.

9:01 am

>wait
Time passes.

Next Yellow Line train in 6 minutes.

Next Red Line train in 30 minutes.

Next Green Line train in 6 minutes.

Next Blue Line train in 6 minutes.

9:02 am

* * *

>wait
Time passes.

Next Yellow Line train in 4 minutes.

Next Red Line train in 28 minutes.

Next Green Line train in 4 minutes.

Next Blue Line train in 4 minutes.

9:05 am

I beg your pardon?

9:05 am

I beg your pardon?

9:05 am

>wait
Time passes.

Next Yellow Line train in 4 minutes.

Next Red Line train in 28 minutes.

Next Green Line train in 4 minutes.

Next Blue Line train in 4 minutes.

9:06 am

* * *

>wait
Time passes.

The Blue Line train pulls up. The door opens.

The Green Line train pulls up. The door opens.

The Yellow Line train pulls up. The door opens.

Next Red Line train in 24 minutes.

9:11 am

>enter yellow
(the Yellow Line train)
You get into the Yellow Line train.

Next Red Line train in 24 minutes.

9:12 am

>wait
Time passes.

The door of the Blue Line train closes.

The Blue Line train sets off.
The door of the Green Line train closes.

The Green Line train sets off.
The door closes.

The Yellow Line train starts moving again.

9:13 am

>wait
Time passes.

The Yellow Line train stops at Mission 16th St. The door opens.

Next Red Line train in 20 minutes.

9:14 am

>wait
Time passes.

Next Red Line train in 20 minutes.

9:15 am

>wait
Time passes.

The door of the Blue Line train closes.

The Blue Line train sets off.
The door of the Green Line train closes.

The Green Line train sets off.
The door closes.

The Yellow Line train starts moving again.

9:16 am

* * *

>wait
Time passes.

The door of the Blue Line train closes.

The Blue Line train sets off.
The door of the Green Line train closes.

The Green Line train sets off.
The door closes.

The Yellow Line train starts moving again.

9:31 am

>wait
Time passes.

The Yellow Line train stops at Oakland 12th St. The door opens.

Next Red Line train in 4 minutes.

Next Orange Line train in 16 minutes.

9:32 am

>wait
Time passes.

Next Red Line train in 4 minutes.

Next Orange Line train in 16 minutes.

9:33 am

>wait
Time passes.

The door closes.

The Yellow Line train starts moving again.

9:34 am

>wait
Time passes.

The Yellow Line train stops at Oakland 19th St. The door opens.

Next Red Line train in 8 minutes.

Next Orange Line train in 14 minutes.

9:35 am

>wait
Time passes.

Next Red Line train in 8 minutes.

Next Orange Line train in 14 minutes.

9:36 am

>wait
Time passes.

The door closes.

The Yellow Line train starts moving again.

9:37 am

>wait
Time passes.

The Yellow Line train stops at MacArthur. The door opens.

Next Red Line train in 12 minutes.

Next Orange Line train in 12 minutes.

9:38 am

>wait
Time passes.

Next Red Line train in 12 minutes.

Next Orange Line train in 12 minutes.

9:39 am

>wait
Time passes.

The door closes.

The Yellow Line train starts moving again.

9:40 am

>wait
Time passes.

The Yellow Line train stops at Rockridge. The door opens.

9:41 am

>wait
Time passes.

9:42 am

>wait
Time passes.

The door closes.

The Yellow Line train starts moving again.

9:43 am

>wait
Time passes.

The Yellow Line train stops at Orinda. The door opens.

9:44 am

>wait
Time passes.

9:45 am

>wait
Time passes.

The door closes.

The Yellow Line train starts moving again.

9:46 am

>wait
Time passes.

The Yellow Line train stops at Lafayette. The door opens.

9:47 am

>wait
Time passes.

9:48 am

>wait
Time passes.

The door closes.

The Yellow Line train starts moving again.

9:49 am

>wait
Time passes.

The Yellow Line train stops at Walnut Creek. The door opens.

9:50 am

>wait
Time passes.

9:51 am

>wait
Time passes.

The door closes.

The Yellow Line train starts moving again.

9:52 am

>wait
Time passes.

The Yellow Line train stops at Pleasant Hill. The door opens.

9:53 am

>wait
Time passes.

9:54 am

>wait
Time passes.

The door closes.

The Yellow Line train starts moving again.

9:55 am

>wait
Time passes.

The Yellow Line train stops at Concord. The door opens.

9:56 am

>wait
Time passes.

9:57 am

>wait
Time passes.

The door closes.

The Yellow Line train starts moving again.

9:58 am

>wait
Time passes.

The Yellow Line train stops at North Concord/Martinez. The door opens.

9:59 am

>wait
Time passes.

10:00 am

>wait
Time passes.

The door closes.

The Yellow Line train starts moving again.

10:01 am

>wait
Time passes.

The Yellow Line train stops at Pittsburg/Bay Point. The door opens.

10:02 am

>wait
Time passes.

10:03 am

>wait
Time passes.

The door closes.

The Yellow Line train starts moving again.

10:04 am

>wait
Time passes.

The Yellow Line train stops at Pittsburg Center. The door opens.

10:05 am

>wait
Time passes.

10:06 am

>wait
Time passes.

The door closes.

The Yellow Line train starts moving again.

10:07 am

>wait
Time passes.

The Yellow Line train stops at Antioch. The door opens.

10:08 am

>wait
Time passes.

10:09 am

>wait
Time passes.

The door closes.

The Yellow Line train starts moving again.

10:10 am

>wait
Time passes.

The Yellow Line train stops at Pittsburg Center. The door opens.

10:11 am

>wait
Time passes.

10:12 am

>wait
Time passes.

The door closes.

The Yellow Line train starts moving again.

10:13 am

>wait
Time passes.

The Yellow Line train stops at Pittsburg/Bay Point. The door opens.

10:14 am

>wait
Time passes.

10:15 am

>wait
Time passes.

The door closes.

The Yellow Line train starts moving again.

10:16 am

>wait
Time passes.

The Yellow Line train stops at North Concord/Martinez. The door opens.

10:17 am

>wait
Time passes.

10:18 am

>wait
Time passes.

The door closes.

The Yellow Line train starts moving again.

10:19 am

>wait
Time passes.

The Yellow Line train stops at Concord. The door opens.

10:20 am

>wait
Time passes.

10:21 am

>wait
Time passes.

The door closes.

The Yellow Line train starts moving again.

10:22 am

>wait
Time passes.

The Yellow Line train stops at Pleasant Hill. The door opens.

10:23 am

>exit
You get out of the Yellow Line train.

Pleasant Hill
You are on a BART platform.

You can see a Yellow Line train here.

10:24 am

>l
Pleasant Hill
You are on a BART platform.

You can see an elevator (empty) and a Yellow Line train here.

The door of the Yellow Line train closes.

The Yellow Line train sets off.

Next Yellow Line train in 3 minutes.

10:25 am

>l
Pleasant Hill
You are on a BART platform.

You can see an elevator (empty) here.

Next Yellow Line train in 2 minutes.

10:26 am

>l
Pleasant Hill
You are on a BART platform.

You can see an elevator (empty) here.

Next Yellow Line train in 2 minutes.

10:27 am

>l
Pleasant Hill
You are on a BART platform.

You can see an elevator (empty) here.

Next Yellow Line train in 5 minutes.

10:28 am

>l
Pleasant Hill
You are on a BART platform.

You can see an elevator (empty) here.

Next Yellow Line train in 4 minutes.

10:29 am

>l
Pleasant Hill
You are on a BART platform.

You can see an elevator (empty) here.

Next Yellow Line train in 4 minutes.

10:30 am

>l
Pleasant Hill
You are on a BART platform.

You can see an elevator (empty) here.

Next Yellow Line train in 7 minutes.

10:31 am

>l
Pleasant Hill
You are on a BART platform.

You can see an elevator (empty) here.

Next Yellow Line train in 6 minutes.

10:32 am

>l
Pleasant Hill
You are on a BART platform.

You can see an elevator (empty) here.

Next Yellow Line train in 6 minutes.

10:33 am

>l
Pleasant Hill
You are on a BART platform.

You can see an elevator (empty) here.

Next Yellow Line train in 9 minutes.

10:34 am

>l
Pleasant Hill
You are on a BART platform.

You can see an elevator (empty) here.

Next Yellow Line train in 8 minutes.

10:35 am

>l
Pleasant Hill
You are on a BART platform.

You can see an elevator (empty) here.

Next Yellow Line train in 8 minutes.

10:36 am

>l
Pleasant Hill
You are on a BART platform.

You can see an elevator (empty) here.

Next Yellow Line train in 11 minutes.

10:37 am

>l
Pleasant Hill
You are on a BART platform.

You can see an elevator (empty) here.

Next Yellow Line train in 10 minutes.

10:38 am

>l
Pleasant Hill
You are on a BART platform.

You can see an elevator (empty) here.

Next Yellow Line train in 10 minutes.

10:39 am

>l
Pleasant Hill
You are on a BART platform.

You can see an elevator (empty) here.

Next Yellow Line train in 13 minutes.

10:40 am

>l
Pleasant Hill
You are on a BART platform.

You can see an elevator (empty) here.

Next Yellow Line train in 12 minutes.

10:41 am

>l
Pleasant Hill
You are on a BART platform.

You can see an elevator (empty) here.

Next Yellow Line train in 12 minutes.

10:42 am

>l
Pleasant Hill
You are on a BART platform.

You can see an elevator (empty) here.

Next Yellow Line train in 15 minutes.

10:43 am

>l
Pleasant Hill
You are on a BART platform.

You can see an elevator (empty) here.

Next Yellow Line train in 14 minutes.

10:44 am

>l
Pleasant Hill
You are on a BART platform.

You can see an elevator (empty) here.

Next Yellow Line train in 14 minutes.

10:45 am

>l
Pleasant Hill
You are on a BART platform.

You can see an elevator (empty) here.

Next Yellow Line train in 17 minutes.

10:46 am

>l
Pleasant Hill
You are on a BART platform.

You can see an elevator (empty) here.

Next Yellow Line train in 16 minutes.

10:47 am

* * *

I beg your pardon?

10:47 am

>l
Pleasant Hill
You are on a BART platform.

You can see an elevator (empty) here.

Next Yellow Line train in 16 minutes.

10:48 am

>l
Pleasant Hill
You are on a BART platform.

You can see an elevator (empty) here.

Next Yellow Line train in 19 minutes.

10:49 am

>l
Pleasant Hill
You are on a BART platform.

You can see an elevator (empty) here.

Next Yellow Line train in 18 minutes.

10:50 am

>l
Pleasant Hill
You are on a BART platform.

You can see an elevator (empty) here.

Next Yellow Line train in 18 minutes.

10:51 am

>l
Pleasant Hill
You are on a BART platform.

You can see an elevator (empty) here.

Next Yellow Line train in 21 minutes.

10:52 am

I beg your pardon?

10:52 am

>l
Pleasant Hill
You are on a BART platform.

You can see an elevator (empty) here.

Next Yellow Line train in 20 minutes.

10:53 am

>l
Pleasant Hill
You are on a BART platform.

You can see an elevator (empty) here.

Next Yellow Line train in 20 minutes.

10:54 am

>l
Pleasant Hill
You are on a BART platform.

You can see an elevator (empty) here.

Next Yellow Line train in 23 minutes.

10:55 am

>l
Pleasant Hill
You are on a BART platform.

You can see an elevator (empty) here.

Next Yellow Line train in 22 minutes.

10:56 am

>l
Pleasant Hill
You are on a BART platform.

You can see an elevator (empty) here.

Next Yellow Line train in 22 minutes.

10:57 am

>l
Pleasant Hill
You are on a BART platform.

You can see an elevator (empty) here.

Next Yellow Line train in 25 minutes.

10:58 am

>l
Pleasant Hill
You are on a BART platform.

You can see an elevator (empty) here.

Next Yellow Line train in 24 minutes.

10:59 am

>l
Pleasant Hill
You are on a BART platform.

You can see an elevator (empty) here.

Next Yellow Line train in 24 minutes.

11:00 am

>l
Pleasant Hill
You are on a BART platform.

You can see an elevator (empty) here.

Next Yellow Line train in 27 minutes.

11:01 am

>l
Pleasant Hill
You are on a BART platform.

You can see an elevator (empty) here.

Next Yellow Line train in 26 minutes.

11:02 am

>l
Pleasant Hill
You are on a BART platform.

You can see an elevator (empty) here.

Next Yellow Line train in 26 minutes.

11:03 am

>l
Pleasant Hill
You are on a BART platform.

You can see an elevator (empty) here.

Next Yellow Line train in 29 minutes.

11:04 am

>l
Pleasant Hill
You are on a BART platform.

You can see an elevator (empty) here.

Next Yellow Line train in 28 minutes.

11:05 am

>l
Pleasant Hill
You are on a BART platform.

You can see an elevator (empty) here.

Next Yellow Line train in 28 minutes.

11:06 am

>l
Pleasant Hill
You are on a BART platform.

You can see an elevator (empty) here.

Next Yellow Line train in 31 minutes.

11:07 am

>l
Pleasant Hill
You are on a BART platform.

You can see an elevator (empty) here.

Next Yellow Line train in 30 minutes.

11:08 am

>l
Pleasant Hill
You are on a BART platform.

You can see an elevator (empty) here.

Next Yellow Line train in 30 minutes.

11:09 am

>l
Pleasant Hill
You are on a BART platform.

You can see an elevator (empty) here.

Next Yellow Line train in 33 minutes.

11:10 am

>l
Pleasant Hill
You are on a BART platform.

You can see an elevator (empty) here.

Next Yellow Line train in 32 minutes.

11:11 am

>l
Pleasant Hill
You are on a BART platform.

You can see an elevator (empty) here.

Next Yellow Line train in 32 minutes.

11:12 am

>l
Pleasant Hill
You are on a BART platform.

You can see an elevator (empty) here.

Next Yellow Line train in 35 minutes.

11:13 am

>l
Pleasant Hill
You are on a BART platform.

You can see an elevator (empty) here.

Next Yellow Line train in 34 minutes.

11:14 am

>l
Pleasant Hill
You are on a BART platform.

You can see an elevator (empty) here.

Next Yellow Line train in 34 minutes.

11:15 am

>l
Pleasant Hill
You are on a BART platform.

You can see an elevator (empty) here.

Next Yellow Line train in 33 minutes.

11:16 am

>l
Pleasant Hill
You are on a BART platform.

You can see an elevator (empty) here.

Next Yellow Line train in 32 minutes.

11:17 am

>l
Pleasant Hill
You are on a BART platform.

You can see an elevator (empty) here.

Next Yellow Line train in 32 minutes.

11:18 am

>l
Pleasant Hill
You are on a BART platform.

You can see an elevator (empty) here.

Next Yellow Line train in 31 minutes.

11:19 am

>l
Pleasant Hill
You are on a BART platform.

You can see an elevator (empty) here.

Next Yellow Line train in 30 minutes.

11:20 am

>l
Pleasant Hill
You are on a BART platform.

You can see an elevator (empty) here.

Next Yellow Line train in 30 minutes.

11:21 am

>l
Pleasant Hill
You are on a BART platform.

You can see an elevator (empty) here.

Next Yellow Line train in 29 minutes.

11:22 am

>l
Pleasant Hill
You are on a BART platform.

You can see an elevator (empty) here.

Next Yellow Line train in 28 minutes.

11:23 am

>l
Pleasant Hill
You are on a BART platform.

You can see an elevator (empty) here.

Next Yellow Line train in 28 minutes.

11:24 am

>l
Pleasant Hill
You are on a BART platform.

You can see an elevator (empty) here.

Next Yellow Line train in 27 minutes.

11:25 am

>wait
Time passes.

Next Yellow Line train in 26 minutes.

11:26 am

>wait
Time passes.

Next Yellow Line train in 26 minutes.

11:27 am

>wait
Time passes.

Next Yellow Line train in 25 minutes.

11:28 am

>wait
Time passes.

Next Yellow Line train in 24 minutes.

11:29 am

>wait
Time passes.

Next Yellow Line train in 24 minutes.

11:30 am

>wait
Time passes.

Next Yellow Line train in 23 minutes.

11:31 am

>wait
Time passes.

Next Yellow Line train in 22 minutes.

11:32 am

>wait
Time passes.

Next Yellow Line train in 22 minutes.

11:33 am

>wait
Time passes.

Next Yellow Line train in 21 minutes.

11:34 am

>wait
Time passes.

Next Yellow Line train in 20 minutes.

11:35 am

>wait
Time passes.

Next Yellow Line train in 20 minutes.

11:36 am

>wait
Time passes.

Next Yellow Line train in 19 minutes.

11:37 am

>wait
Time passes.

Next Yellow Line train in 18 minutes.

11:38 am

>wait
Time passes.

Next Yellow Line train in 18 minutes.

11:39 am

>wait
Time passes.

Next Yellow Line train in 17 minutes.

11:40 am

>wait
Time passes.

Next Yellow Line train in 16 minutes.

11:41 am

>wait
Time passes.

Next Yellow Line train in 16 minutes.

11:42 am

>wait
Time passes.

Next Yellow Line train in 15 minutes.

11:43 am

>wait
Time passes.

Next Yellow Line train in 14 minutes.

11:44 am

>wait
Time passes.

Next Yellow Line train in 14 minutes.

11:45 am

>wait
Time passes.

Next Yellow Line train in 13 minutes.

11:46 am

>wait
Time passes.

Next Yellow Line train in 12 minutes.

11:47 am

>wait
Time passes.

Next Yellow Line train in 12 minutes.

11:48 am

>wait
Time passes.

Next Yellow Line train in 11 minutes.

11:49 am

>wait
Time passes.

Next Yellow Line train in 10 minutes.

11:50 am

>wait
Time passes.

Next Yellow Line train in 10 minutes.

11:51 am

>wait
Time passes.

Next Yellow Line train in 9 minutes.

11:52 am

>wait
Time passes.

Next Yellow Line train in 8 minutes.

11:53 am

>wait
Time passes.

Next Yellow Line train in 8 minutes.

11:54 am

>wait
Time passes.

Next Yellow Line train in 7 minutes.

11:55 am

>wait
Time passes.

Next Yellow Line train in 6 minutes.

11:56 am

>wait
Time passes.

Next Yellow Line train in 6 minutes.

11:57 am

>wait
Time passes.

Next Yellow Line train in 5 minutes.

11:58 am

>wait
Time passes.

Next Yellow Line train in 4 minutes.

11:59 am

>wait
Time passes.

Next Yellow Line train in 4 minutes.

12:00 pm

>wait
Time passes.

Next Yellow Line train in 3 minutes.

12:01 pm

>wait
Time passes.

Next Yellow Line train in 2 minutes.

12:02 pm

>wait
Time passes.

Next Yellow Line train in 2 minutes.

12:03 pm

>wait
Time passes.

Next Yellow Line train in 1 minutes.

12:04 pm

>wait
Time passes.

The Yellow Line train pulls up. The door opens.

12:05 pm

>enter
You get into the Yellow Line train.

12:06 pm

>wait
Time passes.

The door closes.

The Yellow Line train starts moving again.

12:07 pm

>wait
Time passes.

The Yellow Line train stops at Concord. The door opens.

12:08 pm

>wait
Time passes.

12:09 pm

>wait
Time passes.

The door closes.

The Yellow Line train starts moving again.

12:10 pm

>wait
Time passes.

The Yellow Line train stops at North Concord/Martinez. The door opens.

12:11 pm

>wait
Time passes.

12:12 pm

>wait
Time passes.

The door closes.

The Yellow Line train starts moving again.

12:13 pm

>wait
Time passes.

The Yellow Line train stops at Pittsburg/Bay Point. The door opens.

12:14 pm

>wait
Time passes.

12:15 pm

>wait
Time passes.

The door closes.

The Yellow Line train starts moving again.

12:16 pm

>wait
Time passes.

The Yellow Line train stops at Pittsburg Center. The door opens.

12:17 pm

>wait
Time passes.

12:18 pm

>wait
Time passes.

The door closes.

The Yellow Line train starts moving again.

12:19 pm

>wait
Time passes.

The Yellow Line train stops at Antioch. The door opens.

12:20 pm

>wait
Time passes.

12:21 pm

>wait
Time passes.

The door closes.

The Yellow Line train starts moving again.

12:22 pm

>wait
Time passes.

The Yellow Line train stops at Pittsburg Center. The door opens.

12:23 pm

>wait
Time passes.

12:24 pm

>wait
Time passes.

The door closes.

The Yellow Line train starts moving again.

12:25 pm

>wait
Time passes.

The Yellow Line train stops at Pittsburg/Bay Point. The door opens.

12:26 pm

>wait
Time passes.

12:27 pm

>wait
Time passes.

The door closes.

The Yellow Line train starts moving again.

12:28 pm

>wait
Time passes.

The Yellow Line train stops at North Concord/Martinez. The door opens.

12:29 pm

>wait
Time passes.

12:30 pm

>wait
Time passes.

The door closes.

The Yellow Line train starts moving again.

12:31 pm

>wait
Time passes.

The Yellow Line train stops at Concord. The door opens.

12:32 pm

>wait
Time passes.

12:33 pm

>wait
Time passes.

The door closes.

The Yellow Line train starts moving again.

12:34 pm

>wait
Time passes.

The Yellow Line train stops at Pleasant Hill. The door opens.

12:35 pm

>wait
Time passes.

12:36 pm

>wait
Time passes.

The door closes.

The Yellow Line train starts moving again.

12:37 pm

>wait
Time passes.

The Yellow Line train stops at Walnut Creek. The door opens.

12:38 pm

>wait
Time passes.

12:39 pm

>wait
Time passes.

The door closes.

The Yellow Line train starts moving again.

12:40 pm

>wait
Time passes.

The Yellow Line train stops at Lafayette. The door opens.

12:41 pm

>wait
Time passes.

12:42 pm

>wait
Time passes.

The door closes.

The Yellow Line train starts moving again.

12:43 pm

>wait
Time passes.

The Yellow Line train stops at Orinda. The door opens.

12:44 pm

>wait
Time passes.

12:45 pm

>wait
Time passes.

The door closes.

The Yellow Line train starts moving again.

12:46 pm

>wait
Time passes.

The Yellow Line train stops at Rockridge. The door opens.

12:47 pm

>wait
Time passes.

12:48 pm

>wait
Time passes.

The door closes.

The Yellow Line train starts moving again.

12:49 pm

>wait
Time passes.

The Yellow Line train stops at MacArthur. The door opens.

Next Red Line train in 12 minutes.

Next Orange Line train in 12 minutes.

12:50 pm

>exit
You get out of the Yellow Line train.

MacArthur
You are on a BART platform.

You can see a Yellow Line train here.

Next Red Line train in 12 minutes.

Next Orange Line train in 12 minutes.

12:51 pm

>l
MacArthur
You are on a BART platform.

You can see an elevator (empty) and a Yellow Line train here.

The door of the Yellow Line train closes.

The Yellow Line train sets off.

Next Yellow Line train in 3 minutes.

Next Red Line train in 11 minutes.

Next Orange Line train in 12 minutes.

12:52 pm

>l
MacArthur
You are on a BART platform.

You can see an elevator (empty) here.

Next Yellow Line train in 2 minutes.

Next Red Line train in 10 minutes.

Next Orange Line train in 12 minutes.

12:53 pm

>wait
Time passes.

Next Yellow Line train in 2 minutes.

Next Red Line train in 10 minutes.

Next Orange Line train in 12 minutes.

12:54 pm

>wait
Time passes.

Next Yellow Line train in 5 minutes.

Next Red Line train in 9 minutes.

Next Orange Line train in 12 minutes.

12:55 pm

>wait
Time passes.

Next Yellow Line train in 4 minutes.

Next Red Line train in 8 minutes.

Next Orange Line train in 12 minutes.

12:56 pm

>wait
Time passes.

Next Yellow Line train in 4 minutes.

Next Red Line train in 8 minutes.

Next Orange Line train in 12 minutes.

12:57 pm

>wait
Time passes.

Next Yellow Line train in 7 minutes.

Next Red Line train in 7 minutes.

Next Orange Line train in 12 minutes.

12:58 pm

>wait
Time passes.

Next Yellow Line train in 6 minutes.

Next Red Line train in 6 minutes.

Next Orange Line train in 12 minutes.

12:59 pm

>wait
Time passes.

Next Yellow Line train in 6 minutes.

Next Red Line train in 6 minutes.

Next Orange Line train in 12 minutes.

1:00 pm

>wait
Time passes.

Next Yellow Line train in 9 minutes.

Next Red Line train in 5 minutes.

Next Orange Line train in 12 minutes.

1:01 pm

>wait
Time passes.

Next Yellow Line train in 8 minutes.

Next Red Line train in 4 minutes.

Next Orange Line train in 12 minutes.

1:02 pm

>wait
Time passes.

Next Yellow Line train in 8 minutes.

Next Red Line train in 4 minutes.

Next Orange Line train in 12 minutes.

1:03 pm

>wait
Time passes.

Next Yellow Line train in 11 minutes.

Next Red Line train in 3 minutes.

Next Orange Line train in 12 minutes.

1:04 pm

>wait
Time passes.

Next Yellow Line train in 10 minutes.

Next Red Line train in 2 minutes.

Next Orange Line train in 12 minutes.

1:05 pm

>wait
Time passes.

Next Yellow Line train in 10 minutes.

Next Red Line train in 2 minutes.

Next Orange Line train in 12 minutes.

1:06 pm

>wait
Time passes.

Next Yellow Line train in 13 minutes.

Next Red Line train in 1 minutes.

Next Orange Line train in 12 minutes.

1:07 pm

>wait
Time passes.

The Red Line train pulls up. The door opens.

Next Yellow Line train in 12 minutes.

Next Orange Line train in 12 minutes.

1:08 pm

>enter red
(the Red Line train)
You get into the Red Line train.

Next Yellow Line train in 12 minutes.

Next Orange Line train in 12 minutes.

1:09 pm

>enter red
(the Red Line train)
But you're already in the Red Line train.

The door closes.

The Red Line train starts moving again.

1:10 pm

>wait
Time passes.

The Red Line train stops at Oakland 19th St. The door opens.

Next Yellow Line train in 12 minutes.

Next Orange Line train in 14 minutes.

1:11 pm

>wait
Time passes.

Next Yellow Line train in 12 minutes.

Next Orange Line train in 14 minutes.

1:12 pm

>wait
Time passes.

The door closes.

The Red Line train starts moving again.

1:13 pm

>wait
Time passes.

The Red Line train stops at Oakland 12th St. The door opens.

Next Yellow Line train in 12 minutes.

Next Orange Line train in 16 minutes.

1:14 pm

>wait
Time passes.

Next Yellow Line train in 12 minutes.

Next Orange Line train in 16 minutes.

1:15 pm

>wait
Time passes.

The door closes.

The Red Line train starts moving again.

1:16 pm

>wait
Time passes.

The Red Line train stops at West Oakland. The door opens.

Next Yellow Line train in 12 minutes.

Next Blue Line train in 10 minutes.

1:17 pm

>wait
Time passes.

Next Yellow Line train in 12 minutes.

Next Blue Line train in 10 minutes.

1:18 pm

>wait
Time passes.

The door of the Green Line train closes.

The Green Line train sets off.
The door closes.

The Red Line train starts moving again.

1:19 pm

>wait
Time passes.

The Red Line train stops at Embarcadero. The door opens.

Next Yellow Line train in 12 minutes.

*** Run-time problem P21: Attempt to look up a non-existent correspondence in the table 'Table of Green Line Schedule'.

Next Green Line train in 14 minutes.

Next Blue Line train in 16 minutes.

1:20 pm

>l
Embarcadero (in the Red Line train)
You are on a BART platform underground. Lots of people are around and there are muffled announcements over an intercom.

Next Yellow Line train in 12 minutes.

*** Run-time problem P21: Attempt to look up a non-existent correspondence in the table 'Table of Green Line Schedule'.

Next Green Line train in 14 minutes.

Next Blue Line train in 16 minutes.

1:21 pm

>l
Embarcadero (in the Red Line train)
You are on a BART platform underground. Lots of people are around and there are muffled announcements over an intercom.

You can see an elevator (empty) here.

The door closes.

The Red Line train starts moving again.

1:22 pm

* * *

>enter green
(the Green Line train)
You get into the Green Line train.

Next Red Line train in 24 minutes.

9:12 am

>enter green
(the Green Line train)
But you're already in the Green Line train.

The door of the Blue Line train closes.

The Blue Line train sets off.
The door closes.

The Green Line train starts moving again.

9:13 am

>wait
Time passes.

The Green Line train stops at Mission 16th St. The door opens.

The Yellow Line train pulls up. The door opens.

Next Red Line train in 20 minutes.

9:14 am

* * *

>wait
Time passes.

The door closes.

The Green Line train starts moving again.

9:58 am

>wait
Time passes.

*** Run-time problem P61: Attempt to move the player off-stage.

The Green Line train stops at Transitional Location. The door opens.

9:59 am

* * *

>wait
Time passes.

Next Red Line train in 8 minutes.

9:24 am

>exit
You get out of the Yellow Line train.

Montgomery
You are on a BART platform.

You can see an elevator (empty), a Yellow Line train, a Green Line train and a Blue Line train here.

The door of the Blue Line train closes.

The Blue Line train sets off.
The door of the Green Line train closes.

The Green Line train sets off.
The door of the Yellow Line train closes.

The Yellow Line train sets off.

Next Yellow Line train in 3 minutes.

Next Red Line train in 7 minutes.

Next Green Line train in 3 minutes.

Next Blue Line train in 3 minutes.

9:25 am

>l
Montgomery
You are on a BART platform.

You can see an elevator (empty) here.

Next Yellow Line train in 2 minutes.

Next Red Line train in 6 minutes.

Next Green Line train in 2 minutes.

Next Blue Line train in 2 minutes.

9:26 am

>l
Montgomery
You are on a BART platform.

You can see an elevator (empty) here.

Next Yellow Line train in 2 minutes.

Next Red Line train in 6 minutes.

Next Green Line train in 2 minutes.

Next Blue Line train in 2 minutes.

9:27 am

>l
Montgomery
You are on a BART platform.

You can see an elevator (empty) here.

Next Yellow Line train in 5 minutes.

Next Red Line train in 5 minutes.

Next Green Line train in 5 minutes.

Next Blue Line train in 5 minutes.

9:28 am

>l
Montgomery
You are on a BART platform.

You can see an elevator (empty) here.

Next Yellow Line train in 4 minutes.

Next Red Line train in 4 minutes.

Next Green Line train in 4 minutes.

Next Blue Line train in 4 minutes.

9:29 am

>l
Montgomery
You are on a BART platform.

You can see an elevator (empty) here.

Next Yellow Line train in 4 minutes.

Next Red Line train in 4 minutes.

Next Green Line train in 4 minutes.

Next Blue Line train in 4 minutes.

9:30 am

>w
You can't go that way.

Next Yellow Line train in 7 minutes.

Next Red Line train in 3 minutes.

Next Green Line train in 7 minutes.

Next Blue Line train in 7 minutes.

9:31 am

>wait
Time passes.

Next Yellow Line train in 6 minutes.

Next Red Line train in 2 minutes.

*** Run-time problem P21: Attempt to look up a non-existent correspondence in the table 'Table of Green Line Schedule'.

Next Green Line train in 12 minutes.

Next Blue Line train in 12 minutes.

9:32 am

* * *

>wait
Time passes.

Next Yellow Line train in 5 minutes.

Next Red Line train in 29 minutes.

Next Green Line train in 5 minutes.

Next Blue Line train in 5 minutes.

9:04 am

>wait 2 minutes
I only understood you as far as wanting to wait.

* * *

Transitory
An Interactive Fiction by lizzard
Release 1 / Serial number 190126 / Inform 7 build 6M62 (I6/v6.33 lib 6/12N) SD

Mission 24th St
You are underground, on a BART platform. The hollow sound of vibrating train rails echoes through the station. Boxy concrete arches run overhead and then frame the sides of the train tunnel. If you look around, you will probably find the elevator. On the platform itself, the floor is covered with long brick-red tiles, while the median walls are tiled in muted orange, gold, and brown, like a desert sunset.

9:00 am

>wait for train
I only understood you as far as wanting to wait.

9:00 am

>wait bart
I only understood you as far as wanting to wait.

9:00 am

>wait
Time passes.

Next Yellow Line train in 7 minutes.

Next Red Line train in 31 minutes.

9:01 am

>look
Mission 24th St
You are underground, on a BART platform. The hollow sound of vibrating train rails echoes through the station. Boxy concrete arches run overhead and then frame the sides of the train tunnel. An elevator is in the median wall to the north. On the platform itself, the floor is covered with long brick-red tiles, while the median walls are tiled in muted orange, gold, and brown, like a desert sunset.

You can see an elevator (empty) here.

Next Yellow Line train in 6 minutes.

Next Red Line train in 30 minutes.

9:02 am

>enter
You get into the elevator. The doors close. Best to go up or down as fast as possible to get out of the stench.

Next Yellow Line train in 6 minutes.

Next Red Line train in 30 minutes.

9:03 am

>down
You can't go that way.

Next Yellow Line train in 5 minutes.

Next Red Line train in 29 minutes.

9:04 am

>up
 The elevator almost imperceptibly moves up. Time passes. You smell a lot of things, wishing you couldn't. The doors open again.

Mission 24th Concourse (in the elevator)
Enormous concrete buttresses soar overhead, like a futuristic 70s airplane hangar. Music echoes hauntingly from a monumental stairwell rising up to the plaza, combining with the wild harmonics of trains below. 

9:05 am

>leave
You get out of the elevator.

Mission 24th Concourse
Enormous concrete buttresses soar overhead, like a futuristic 70s airplane hangar. Music echoes hauntingly from a monumental stairwell rising up to the plaza, combining with the wild harmonics of trains below. 

You can see an elevator (empty) here.

9:06 am

>look
Mission 24th Concourse
Enormous concrete buttresses soar overhead, like a futuristic 70s airplane hangar. Music echoes hauntingly from a monumental stairwell rising up to the plaza, combining with the wild harmonics of trains below. 

You can see an elevator (empty) here.

9:07 am

>exit
But you aren't in anything at the moment.

9:08 am

>up
That's fairly challenging since your wheels won't make it up the stairs.

9:09 am

>enter
You get into the elevator. The doors close. Best to go up or down as fast as possible to get out of the stench.

9:10 am

>up
 The elevator almost imperceptibly moves up. Time passes. You smell a lot of things, wishing you couldn't. The doors open again.

Calle 24 Northeast Plaza (in the elevator)
Palm trees sway high overhead. Delicate metal rails surround the enormous circular stairwell that goes down to the station concourse. All around you are little shops, restaurants, taquerias, people talking, buses pulling up to the stops on Mission and on 24th Street, music blasting from cars going by. A huge mural runs across the wall of the taqueria bordering the plaza to the north, of a gleaming BART train carried on the backs of determined workers amid a geometric cityscape.

You can see a tamale lady and a yelling preacher here.

A tamale lady watches the people passing by.

If you look around past the crowds you might find the elevator.

9:11 am

>listen
You hear nothing unexpected.

A tamale lady says "Tamales de pollo!"
.

9:12 am

>z
Time passes.

A tamale lady shifts her weight from one foot to the other.

9:13 am

>.
That's not a verb I recognise.

9:13 am

>z
Time passes.

A tamale lady shifts her weight from one foot to the other.

9:14 am

>buy tamale
Nothing is on sale.

A tamale lady says "Tamales!"
.

9:15 am